ATTGATACGCACCGGTTTCGCCGGATCCTTG	Mycobacterium abscessus subsp. abscessus
GTCTCCGTTGTTGCGGGTGCGCGCATAAAGC	Mycobacterium abscessus subsp. abscessus
ATCTCGAGCTCTTTGTAGACGCTGCTCCACA	Mycobacterium abscessus subsp. abscessus
AACTGCGCGTCGCGTTATCGCTCAAGGTTCC	Mycobacterium abscessus subsp. abscessus
CGCTCTCATGACCTGGTGATCTTAGATCGGT	Mycobacterium abscessus subsp. abscessus
ACATTGATACGCACCGGTTTCGCCGGATCCT	Mycobacterium abscessus subsp. abscessus
TCACCTGATTGGGGCGGAAACCAGCGACGGC	Mycobacterium abscessus subsp. abscessus
ACGTCGACGACCGGACGGCGGGCAGCTTCTT	Mycobacterium abscessus subsp. abscessus
GAGTTCACCTGATTGGGGCGGAAACCAGCGA	Mycobacterium abscessus subsp. abscessus
CTCTTTGTAGACGCTGCTCCACAACCGCGTC	Mycobacterium abscessus subsp. abscessus
CTGGCTCCAGACGCCGTGGAAGCTCACCACG	Mycobacterium abscessus subsp. abscessus
CGTCCAAGGTCTGGTCGGTGTGCGAACGTCC	Mycobacterium abscessus subsp. abscessus
CGGCGCCAAAGTCGAGCACATTGATACGCAC	Mycobacterium abscessus subsp. abscessus
TGCTGATCGGAGTCGGCGCCAAAGTCGAGCA	Mycobacterium abscessus subsp. abscessus
GCGTCTCCGTTGTTGCGGGTGCGCGCATAAA	Mycobacterium abscessus subsp. abscessus
TGGTCGGTGTGCGAACGTCCCGCCACTACCA	Mycobacterium abscessus subsp. abscessus
GGAGAGCGACCGCGCTCGCGACACCTACGAG	Mycobacterium abscessus subsp. abscessus
GGAAACCAGCGACGGCGTCCTGGTACAGGGC	Mycobacterium abscessus subsp. abscessus
TCGACGACCGGACGGCGGGCAGCTTCTTGCT	Mycobacterium abscessus subsp. abscessus
CGTCGGCGACGCTCTGCGAACGGGGCATCCC	Mycobacterium abscessus subsp. abscessus
TTGCTGCGGCAGCGGGCATCGTCGCAGCCGG	Mycobacterium abscessus subsp. bolletii
CGTAACCGGCGGCGCGTTCCAGCGATATGAC	Mycobacterium abscessus subsp. bolletii
CAGGGGCGCGGTGCGCTCCGGTTTGTTGACC	Mycobacterium abscessus subsp. bolletii
GATAGGGCGGTAGTGGGCTTCACCCGGGCGC	Mycobacterium abscessus subsp. bolletii
CGAAGCCCTGGATGAGCTTACGACGTGCACC	Mycobacterium abscessus subsp. bolletii
GCGAGATCTTCCGTGCCACACCGGAGTCCGC	Mycobacterium abscessus subsp. bolletii
CGACGCCACTGCCCTGCAGTGGTGCGAAATC	Mycobacterium abscessus subsp. bolletii
TGCTCCCAGTGCCCCCGGGGGATCATCGGAC	Mycobacterium abscessus subsp. bolletii
ACTCCAAATATGCCGAATCCGTATCGATGGC	Mycobacterium abscessus subsp. bolletii
ACGGAGATGCGGCAACACGGCCGCCGCGCGC	Mycobacterium abscessus subsp. bolletii
ACCAGGCGGCGCAACGCGTTTCCGATGCGGC	Mycobacterium abscessus subsp. bolletii
GCCGAACTTGGTGTCACAAGTCCGGTTACTG	Mycobacterium abscessus subsp. bolletii
GTATCACCGTGGACGAACCGACCAAGCGGTT	Mycobacterium abscessus subsp. bolletii
GACCACTGCGGCTTACCCAGCTTGCCGGTGT	Mycobacterium abscessus subsp. bolletii
TGTCACTGCCGTACCGATACGTACCGACGAG	Mycobacterium abscessus subsp. bolletii
TAGACCCACATGGCCGCCGCCGGTTCGCGCG	Mycobacterium abscessus subsp. bolletii
CGAAACCGTGACGATGTGCTCTTGATCAGCA	Mycobacterium abscessus subsp. bolletii
CACCCTGACCCGCCATGAGTTCGAGGCCCAC	Mycobacterium abscessus subsp. bolletii
TGTCCGAGCGGGAGGCCGGAAGTGACGCCGC	Mycobacterium abscessus subsp. bolletii
GTCAGGAAGGTCGGACGGGGTCAATCGGTGA	Mycobacterium abscessus subsp. bolletii
GGCGCTGGCCATTACCGACCACAACGGTTTC	Mycobacterium abscessus subsp. massiliense
TCTGGGGTTGGCGGAAGTCGCCGATGCCCTC	Mycobacterium abscessus subsp. massiliense
CCCATATCGACCTGAAGGAGCCTGCGGTCTA	Mycobacterium abscessus subsp. massiliense
GTCGTCGAACGGGTGCGGGCGGCATTGGCCG	Mycobacterium abscessus subsp. massiliense
TCGCCGGTGCCGCTCGAGAAAGCGCTGTGGC	Mycobacterium abscessus subsp. massiliense
AACGGCCAAACCGGCGAGACTCAACGACGAC	Mycobacterium abscessus subsp. massiliense
GTTGGATCACCGAGGAATCGACCGCCGATGA	Mycobacterium abscessus subsp. massiliense
CGAAGTCGTTGTACGAGGTGTGTGTGAAGGC	Mycobacterium abscessus subsp. massiliense
TCACCCCCTCGTCGTGGCGCGCCAGGTTGAT	Mycobacterium abscessus subsp. massiliense
CGGTGCTGCGCCGCCACATCCTGGAAAATCC	Mycobacterium abscessus subsp. massiliense
CGGACAGTGCGTAGGAGGCCATCGCCTCGCC	Mycobacterium abscessus subsp. massiliense
CCGGCGCGGGGATGGTCGGCAGCGGGAAGCG	Mycobacterium abscessus subsp. massiliense
CCGATGGCGTCGGCCACGGTGTTGGCGGGCA	Mycobacterium abscessus subsp. massiliense
CGGCGAGGACACCGCCGGGGCGCTGAGCGCC	Mycobacterium abscessus subsp. massiliense
CGAATGGGCACGCATGGAAAACCGTAGTGTG	Mycobacterium abscessus subsp. massiliense
GACGACGGCAGGGAAGGGGCCGTCACCGTGG	Mycobacterium abscessus subsp. massiliense
AAGGCGACAGCCTTACGAACCGCCACCGCAG	Mycobacterium abscessus subsp. massiliense
AACCGTCTTGTTCCGGAGGCTGGTCGGGCGA	Mycobacterium abscessus subsp. massiliense
CGTCTCGCAATGGCGAGGCCTACATGAATGA	Mycobacterium abscessus subsp. massiliense
CCGATCGTTCCCGCCACCTCGGCCAGCACCG	Mycobacterium abscessus subsp. massiliense
CGGGCATCCACGCGCCGGTTGCCGCGGCGCA	Mycobacterium agri
GGGCAAATTGACCGAAACGGCGCAGAGAAGC	Mycobacterium agri
TGCCATCCCCGCGCAGGGGTCGGCGACCGTC	Mycobacterium agri
GTGAAGACTGTCGCCGCAGATCTCGGGCCGG	Mycobacterium agri
GCATCGAGGGCTGGCAGCGCGACTGGGGCCG	Mycobacterium agri
GCGGGCGATGGCGACTTCCATCAGCTCCATC	Mycobacterium agri
TGCATTGGATAGGGCTGGTTGCGAGCAGGCC	Mycobacterium agri
GGCCGTCACCTTCAACAGAGTCTGCGTCGGA	Mycobacterium agri
GGAGGTCTGGGACACCGAAGACCGGGCTGAG	Mycobacterium agri
CACCGTCAGCTGGCTGCCCTACGGCGGGCCG	Mycobacterium agri
CGTCATCGCGTGCAGTTCGGCCAGCGCGCGT	Mycobacterium agri
AACGAGTTCATCTTATCGTTGGACCAGGCTA	Mycobacterium agri
CAACGCACCGGTCATCGTCGCCGTTACAGCA	Mycobacterium agri
CGTCTACCCGCGCGCCGAATTCGAGGCACTG	Mycobacterium agri
GTCGTCGGCTATGAGACCTACCTGCAGACCG	Mycobacterium agri
GACGCTGCGCGCCCGGTAGTCGGCGGCCAGC	Mycobacterium agri
GTGCATCCGCCGGTCGCGCGGGCCATAGGGG	Mycobacterium agri
CCCGGTCACGCTGCGGTGGGTGCAGGCGGAG	Mycobacterium agri
GCGAACGTGCCGAACACCAGCGCCACCATCC	Mycobacterium agri
GCAATGAGGGTGCGAAGCCCGTTGAGAAGAC	Mycobacterium agri
CGCACCGGGGCAACTCGACTTCCTCGGCTAC	Mycobacterium aichiense
GATCGTGGACCGTGGGTTGCCGGTGATGGAC	Mycobacterium aichiense
ATCCGGGCGGCCGGCGGTGCCGTCGCCGACC	Mycobacterium aichiense
CGCGCTGCAGGAGGTGCATCTGGCCCTTCCG	Mycobacterium aichiense
GATCAACTCGATGGCTTCCGTCAGGAGCACA	Mycobacterium aichiense
CGCGCCATACGACTCCGGCGCCCTGGTCGGG	Mycobacterium aichiense
CACCCTTGTCGGTGTCGATGACGGCGAACTC	Mycobacterium aichiense
GACGGCCGCCCCAGCTGGGTACGGCTGGACC	Mycobacterium aichiense
GGACGTCGTTCTGCGGATCGATGATGACAAC	Mycobacterium aichiense
CGAATTCGCGTTGCCCGGCGGTGACGGCGCC	Mycobacterium aichiense
CAAGCGGCAGGACGCCGCGTCGATGACGACC	Mycobacterium aichiense
ATGATCGCAATATCGAAGTGCTCCAACAACT	Mycobacterium aichiense
GCGCGACCCGCACGGGTGGTCGGGGTACCTG	Mycobacterium aichiense
CGCACCCAGCCCGATGACCACCACAGTGCCG	Mycobacterium aichiense
GCGCAGCGCCGACGAGATCGCGGTGGCGTCC	Mycobacterium aichiense
TCGGCGTAGGCGATCGCTGCCCGCTCGTCGT	Mycobacterium aichiense
CCAGTCCGTCGGAGAGCATGAACCTGGCGAC	Mycobacterium aichiense
TGAAGATGGTCGAATTCCACGCCGGGCTGGA	Mycobacterium aichiense
GCCGATCTACTCGTGGTGACGGTGGATCTCG	Mycobacterium aichiense
TCGGTGACGGACCGCTTCGCCCAGATGCAGG	Mycobacterium aichiense
AGGAACACCCAGACCGGAGGCGGCATAACCT	Mycobacterium algericum
GGACGTCCCAGGCCCCCGCGGCTGCCAACAG	Mycobacterium algericum
ACCGGCGGTGCGGCCGGCAGTGCCGGCAACG	Mycobacterium algericum
CCAGATCGACCTGGACGATGCGCCGGGCAGC	Mycobacterium algericum
GTCCAGCGCTGGTGGTCGCCGCCAGTGGCAG	Mycobacterium algericum
CCCTGATCGAGATGGCGCTGGCGGCGGGCAG	Mycobacterium algericum
CCGCGGGCAGGTCGAGCATCCGCTGTCCGGC	Mycobacterium algericum
GAAGCGCGAGGAGCCCATCAGCGACACCGCC	Mycobacterium algericum
CCCCACCAGGTGACCCGGGATACCGTGCGGG	Mycobacterium algericum
CGCTCCTGGAGTCGCCGCTCGGGCAGCTGCT	Mycobacterium algericum
CGGCAGCGGCTCCGCGGTTACGGCGGCAACG	Mycobacterium algericum
CCGCCCATCCGGATGAATCCGCGCTGAGTGT	Mycobacterium algericum
AACGCGGTCACCGGGCGTTGCGCGTTGGTCG	Mycobacterium algericum
CGCCATGTACGGCTACGCGGCCAGCTCGGCG	Mycobacterium algericum
GCAGCGATGCGGGCGGCATGATCGCCCACGG	Mycobacterium algericum
GCGGCAGGGGACTGGTCGTCTCGATCGCTGT	Mycobacterium algericum
TACTGGTGCCGACCGTGCCGCGACGAGTTGC	Mycobacterium algericum
ACCAAAGCACAACCGGTCCCGGGCGGAGAAG	Mycobacterium algericum
TCATCGCGGCGAAATCGGCGGGGTCGGCAGC	Mycobacterium algericum
ATGCATGGCAGCCAGGTCACGAACGTCGATC	Mycobacterium algericum
GACGACGTGCTCGGCGCGATCGACGAGCTCG	Mycobacterium alsense
GCCTCGGCCGAGAGCCGCCGCAGCTTGCGCG	Mycobacterium alsense
CCTGCGCGACTGCCCGATCGGGGTCAGCCGA	Mycobacterium alsense
GCGCATCGCGGCCAACGCGCCGCTCGCGGTC	Mycobacterium alsense
CCCCGACGGCAACCTCATCGACAACGCCCTG	Mycobacterium alsense
ACGTCGACCTTGTGGTAGTGCAGGGCGTGCA	Mycobacterium alsense
GATCCACGCCGGCGCGGCGCAGGGGGTTTCG	Mycobacterium alsense
ATAGACCAGGACCAGCAGGACCACGCTGCCG	Mycobacterium alsense
GTCGAGCGGACGTGGTGGATGAACCACCCGA	Mycobacterium alsense
CTCAACACCGGCACGCTGCCGTTGTCGGCGA	Mycobacterium alsense
GCGCCAGCGCAGGGGCTGACCTCCGTGCTCG	Mycobacterium alsense
AAGCGCGAACAGGCGCTCAACTTCGGCGCCA	Mycobacterium alsense
TGGATCAACCTGCATTTTTCGCTGCTGCCCG	Mycobacterium alsense
CGGCGGCGCGCGACGCGCTGGGCATCGCGCT	Mycobacterium alsense
CGCTGGCGCTGCAACTGGTCGACCGCGCGGA	Mycobacterium alsense
GTGCGTCTGGACCGCTACCTCTATACGTCGA	Mycobacterium alsense
CCGGCACCAACCCGTTCAAGCGGCGCCTGCC	Mycobacterium alsense
TTCGCCGACGCCGCCTCGCTGGCGGCGTTCG	Mycobacterium alsense
CCGCTGGGTGCCATCAGACCGCGGCTGCGGC	Mycobacterium alsense
AGACGGGTTCGTCGCGGTAGCGCCGCACGGC	Mycobacterium alsense
CCCAGGCGGTGCTGTCGCCGAAGCCTACCTA	Mycobacterium arupense
ACTGCAAGATCTTGGCCCCGGTGAGCGCCTC	Mycobacterium arupense
GTCCAGCAGCCCGGCTGACACCGATTCCGCG	Mycobacterium arupense
GGGGCGGCGCAGCTCGAAGCGCCGCATAAAC	Mycobacterium arupense
AGTCCGGCCCGCCCGACAGCCCGACCGCCCA	Mycobacterium arupense
GAGGGCTACGTGGAAGCCGCCAGCGAGCGCT	Mycobacterium arupense
GCAGCACTGCTGGAGAGCGCCGACGGGCGGG	Mycobacterium arupense
CGACATGCAGGACACCGCCGGGCGCGCGCTG	Mycobacterium arupense
GTGGCGTTGTGGTCGTTCTCGCCGGGCAAGG	Mycobacterium arupense
GCCGACCCGGCGGCGGTCCATGCCGCGCTGC	Mycobacterium arupense
ATCCTCCTAGCGCCGATGGCGCTGGCCGCGG	Mycobacterium arupense
CCGCCGACGGCAGCGGCCTGCTCGACGGCGT	Mycobacterium arupense
TCCGGGTCTCCAATACCGCGCCCACCTGAGA	Mycobacterium arupense
CCCCGTCGGTACCGATCTTCTCCAGGGCGGC	Mycobacterium arupense
CCCTCGGCTGGAATGTGCTCCAGCCCGAGAT	Mycobacterium arupense
ACTTCCCTAGTCACGGAACCGGATGTTGAGG	Mycobacterium arupense
TGGCACCCATGACTGCACCGGAGACCCTGGA	Mycobacterium arupense
GGTAGGTGCCGGTGTAGCTCTCCAGTGACTT	Mycobacterium arupense
GGTAGCGTCCCGCGGCCGCCTTGGCCATCGA	Mycobacterium arupense
GCTCCTGGACCGCACCGGATTCCGCACAGGA	Mycobacterium arupense
TCGATCGCAAGATCGCTGGCCCGTCAACCGG	Mycobacterium asiaticum
ACCGATGCGACATCGAACTCGGCCCCCTCGT	Mycobacterium asiaticum
AACCGCGCCGCGGTGACCTCGCCGACAATCC	Mycobacterium asiaticum
ACCGTGAGGCAAAGCATCGCGCCACCACCCA	Mycobacterium asiaticum
GCGCTTGCATCGAGCGTGGGCCTCAGGTAGG	Mycobacterium asiaticum
CACCAGCGGGACATCGGGCAGCTCGCCCTGC	Mycobacterium asiaticum
AGTGCTACTTGGAGGTTCGCTGCGCACCGAC	Mycobacterium asiaticum
TGTGTCCGCAGCCAGCAGCAGCCGCATGAAT	Mycobacterium asiaticum
ATGGTCGCGCCGTCGATGCTTTCCCGGACGA	Mycobacterium asiaticum
GTTTCCACGTCTGGTACTGCGGACCCGAGAT	Mycobacterium asiaticum
CTGCCAGTACCCAGCCTCGCCCGACAAAGCC	Mycobacterium asiaticum
GAACACCTGAGGAGTCAGAGCCCGCGCACCG	Mycobacterium asiaticum
CATCACCCCTGGTATCTCGATGGGTTCGTTT	Mycobacterium asiaticum
GCGTGGATGCGTTGTTCGGGCCGGCCGGACA	Mycobacterium asiaticum
TGATCACCGCCGCGGCCAGCTCGGGCGGCGG	Mycobacterium asiaticum
CTGGAAAGTTGCTGTGAGAAACCTGGGTGAT	Mycobacterium asiaticum
CGGCCTGCCTTGCCGAGGTGCCGGGCCACGA	Mycobacterium asiaticum
GGAGCTTGGGGCCTGGGCCGCGGTGGCGCAG	Mycobacterium asiaticum
GACCTTGCGGCCGCGTGAGATTCGTTTGTGT	Mycobacterium asiaticum
GGCTTCGTGCTCGCCGGTCGACGCGCCGGAC	Mycobacterium asiaticum
CTCAAGGCGCTGGCGAAAAATCCCGAAAACC	Mycobacterium asiaticum_C
GTGGGCGTTGCAGCGTTCCGCGATGTATAGA	Mycobacterium asiaticum_C
CGTCGGCGCGGCAGAGTTCGACCGTGCCGGC	Mycobacterium asiaticum_C
CGACCGCCGCACGCGAGGCCCCGACCGCGGC	Mycobacterium asiaticum_C
CCCCGCCGTCCAGGCCATTCTCCAGTCCGAT	Mycobacterium asiaticum_C
GGGTGCTTGATGACAAACGCCCCGAGGTCAA	Mycobacterium asiaticum_C
CACGGCGCGGTACCCGCAGCGAGACCCTGGC	Mycobacterium asiaticum_C
GCCGATAACAGGATCACGGCGGCGAGCACAC	Mycobacterium asiaticum_C
CAACCGAATTTCGACGCGTTGTGGGGTGGCA	Mycobacterium asiaticum_C
TGTGCGAAGAACGGCAAGCCCAGTCCCAGGA	Mycobacterium asiaticum_C
AACGAAGAGTATCGGCAGCGGTTCAACCGCG	Mycobacterium asiaticum_C
CTGGGGGTTCAACTACGAGAACCGCATCTTT	Mycobacterium asiaticum_C
CAGTGTCTCTTCCAATCCGTCTCCGTCACAA	Mycobacterium asiaticum_C
CGGCCACCGGTACGCACCTGCATGTGCCGAC	Mycobacterium asiaticum_C
CTTCGTGATCTACGTCATCACCATTGTGTGC	Mycobacterium asiaticum_C
GGCCAGTGCTCTCGGGCGGCGCGACCGGTGG	Mycobacterium asiaticum_C
ACCGCAACCCGACCCTGCTCGCGAAAATCAT	Mycobacterium asiaticum_C
CGGCTCGATCGGTACGGTGACCAGGCCGGGC	Mycobacterium asiaticum_C
GCTCCCCGCTGGGGGTTTCGTCGATCAATCG	Mycobacterium asiaticum_C
GGCCGTCAGATCCTCGAACCGCGCGCTGAGT	Mycobacterium asiaticum_C
CAGCACCGCCACCAGTAGCAGCAACCCAAGC	Mycobacterium attenuatum
AGGTGCGGGCACAGGGTGCGGATCGGTTCAG	Mycobacterium attenuatum
GCGACGCGTCCAGGACCGAGACTGGCCACCG	Mycobacterium attenuatum
CGGTAGCCCCCGCAACACGGTCGAAGTAACC	Mycobacterium attenuatum
GCGTCGGCGAAGAAATCGTCAAAAAAGCGGG	Mycobacterium attenuatum
TGGACACCGTCGGGGTCGTTGACGGTGACCT	Mycobacterium attenuatum
TGCCTCCTGCCACAACTTCACCGGCAAGGGC	Mycobacterium attenuatum
GGCGCAGCTCATCAGCACGGCTGCCATACCG	Mycobacterium attenuatum
ACGTTCGGGTGCAACCGCGTTCACTGGTTAC	Mycobacterium attenuatum
GAACCACACCACCAGACCTTCGCCCTGATTG	Mycobacterium attenuatum
AGCCCGCCAAGAGCATGTCCTTCCAGGTCTT	Mycobacterium attenuatum
CGTGGGACGGGTCCCCGTAGCCGAGGTTGAC	Mycobacterium attenuatum
CAGCCGGCGGGTATTGCCCTTGGCGGCCGGC	Mycobacterium attenuatum
GGACCGCCGAGAAGATCGTTTCGGTGTCGGC	Mycobacterium attenuatum
GCGGTGAACTGCAACCCGTCGATCGCCAGGA	Mycobacterium attenuatum
ATCGTCATATTTGCGGATGGGCAGTTCACTG	Mycobacterium attenuatum
TTTTCCTAACGATCAGCGCCGAACCAACCCG	Mycobacterium attenuatum
GTCCGGTGCTCAAACCGCCGGTGTGGGAGTG	Mycobacterium attenuatum
GTGGTCGGGGCCGGACTCACCCCTGGCGAAC	Mycobacterium attenuatum
TCCGACGTCGACCGCGACGGCTTCGACCGTC	Mycobacterium attenuatum
CGATCAACTGGTCGGTGAACTGCTCGACCGC	Mycobacterium aubagnense
GCTCCAGAGCCCAAGGTGCTGCCGGTCACGA	Mycobacterium aubagnense
GACACGGTGCCGCTGGGGCCGGACTCGCTGA	Mycobacterium aubagnense
AGGATCGGCGCGTCGCGCCATGCCGAATCAG	Mycobacterium aubagnense
CGTGGAGACGCCGAGAAGCGCGCGAGCCGTG	Mycobacterium aubagnense
TGGCGCGGTGGCGGTCGCAGAGATCGCCGCC	Mycobacterium aubagnense
CAGCCGGGTGGGCTGTCGGTGCCACGTAAGG	Mycobacterium aubagnense
GCCTTGCCGATGGTGTAGATGGTGCCGACCA	Mycobacterium aubagnense
GGCACCGGCACCAAGTTCCAGCGTGTGCATC	Mycobacterium aubagnense
CTCCGGGCCGTACCAGATCGATCCTGGCATG	Mycobacterium aubagnense
CTCCGACGCTGTTGCTGCAGGGCACCGCCGA	Mycobacterium aubagnense
CGCTGGACACGCTCACCGGCCCGGCCGTGGA	Mycobacterium aubagnense
CTGTTGGCCGAGCACGCCGATCTCGAGCGGC	Mycobacterium aubagnense
GCATCAGCACCGCGCCGGAGCCGTCCACACA	Mycobacterium aubagnense
ACGCCAAAGAGCACCAGAGACGACGGGCCGG	Mycobacterium aubagnense
TCTTCTCATCGGCGCCACAGCGGTCGCCGAG	Mycobacterium aubagnense
GAGCGCCCGACACGCCGCCTGAGGACACGCC	Mycobacterium aubagnense
GTACGGCGACATCCAACGCCTGGACCGCATC	Mycobacterium aubagnense
CGGCTCCGATTGTGGCCTGGCCGCACACCAC	Mycobacterium aubagnense
GACGTTCATCAGGCCAGCTTGCGCAGCCGAG	Mycobacterium aubagnense
ACGGCCCCGGGCCGTCGTCGGCGCGGCGATC	Mycobacterium aurum
CGCGAGTCCTGCGGAGCCCGACGTCGCGGAG	Mycobacterium aurum
ACGGCGTCGGCCGCGTTGATCGCGCCCGGAA	Mycobacterium aurum
GTCATCAGACGCTGCGCGCGCTGGTACTGCT	Mycobacterium aurum
TCGACGTGGTGTTCGCCAACGCCGGCGGCGG	Mycobacterium aurum
CGCGCTGCCGCTGTTCCCCGCGGCGGTCGCC	Mycobacterium aurum
GACCTTCCGTCGCACGGCCGCAACGGATTAC	Mycobacterium aurum
CCCGAGGTAGTCCAGAAGGCCGGGTTCGTCG	Mycobacterium aurum
CCGGCTTTCCCGGCTTCGAGACCGCCGGCGA	Mycobacterium aurum
TGGATGCTGTCGACGAAACGGCCGCCCTGCT	Mycobacterium aurum
CCATCTCCGTCAGCTCCGGACGTCGACGGCG	Mycobacterium aurum
TCGACCGGGTGACGATGTTCGTCACGGGCAT	Mycobacterium aurum
GAGACCTGTCTGCGGACCGGCCACGTACAGG	Mycobacterium aurum
GGGCGACGACCATGACGCCGGACGTGCCGAC	Mycobacterium aurum
GCTCAGCGGTCCGGTGACCGGCACCGCGGTG	Mycobacterium aurum
CCGCCGGTTCTTCGAGGGTAAGCCGCTGCGC	Mycobacterium aurum
GTCGCGAAGATGTCCGCAACCGCCACCGTCG	Mycobacterium aurum
CACTGCCTCCGGTGCTGCATGCCACAGCGGT	Mycobacterium aurum
GACGCGGCGGACAAAGGCCGCCATCCACTGG	Mycobacterium aurum
CGCCGGATACTGCCAACTACTGCCAGGCCCA	Mycobacterium aurum
GCGCGGCGCAGCCAGCCGTACCCGTCCAGTT	Mycobacterium austroafricanum
TCCTGCGGTTGCGGCCCGACACCGATGTCCG	Mycobacterium austroafricanum
TGCGCAGCAGGACAATGCAGGGCACGGGGTG	Mycobacterium austroafricanum
GAAGGCCAGGTGATCGGCCCAGGCACGGTCG	Mycobacterium austroafricanum
TGCCGATCGACGGTGTGTCTCCTCCGAGCAC	Mycobacterium austroafricanum
GGCAAGACGTATACCACCGAGGGCAATGCGT	Mycobacterium austroafricanum
AATTCCCAAGGTGGGCAAGAAGACCGCCGAA	Mycobacterium austroafricanum
TCCGCGACGCGACCTCGGGCAGGTAGCCGAA	Mycobacterium austroafricanum
CGGCCTCCAACGCGCTGTTGAACGTCGCGCT	Mycobacterium austroafricanum
GATGTCGATGAGGCGGTACGGCGCTGCCGCC	Mycobacterium austroafricanum
CCGCGTCCAGCGTGCGCGGATAGGCGCCGAG	Mycobacterium austroafricanum
ATTCCACGACCGACTGCCCTCCGCTACGTGC	Mycobacterium austroafricanum
ATCAGTGACGGTGCCGTCGGTGACGGTACCG	Mycobacterium austroafricanum
CGTCACCGGGATGAACACCTTGCGCGAATAA	Mycobacterium austroafricanum
CTTCCCCGACGGCCGCGGCGACCCGCTTGGC	Mycobacterium austroafricanum
CCGACCTCGGCGATGTGCCCGGCATAGCCCA	Mycobacterium austroafricanum
GAAGCCGCGGGCCGGGTCTTCGGCGTACACA	Mycobacterium austroafricanum
CGGGCGTCCGCACCGCCCATCACGCGGTGGT	Mycobacterium austroafricanum
GGACGCCGCGATCGCCGCCTACCGCGCCGAC	Mycobacterium austroafricanum
CCGGGTGCGGGCCACAGCGAGACGATGATGC	Mycobacterium austroafricanum
GCTCACCGAGCCACAGCTCCAGGTCGTCGCG	Mycobacterium avium
GCGCGCCGGGTGTTGAGCCGGAAGAACTCCG	Mycobacterium avium
GGCCGATGCGGTCGCGGCCGTAGCGGGCGGT	Mycobacterium avium
TGGTTCATGAATTCGTCGACGTTGTCCGCGA	Mycobacterium avium
ACCCCGGTGCTCAGCTGCTCGGCCGGGGACA	Mycobacterium avium
CGGCCAGGATGAGCCCGGTCATCGCGCCCGG	Mycobacterium avium
GTCACGAACCCGACACCCGCGACGATCAGCG	Mycobacterium avium
CCAAGAAGCCGGGGCCACAGCCGATTTGGAG	Mycobacterium avium
TGGCCTGCGACCGGGCCCAGCGCACCACGGC	Mycobacterium avium
CCGGCCAGGCCCGCGCTCGCCCACACGGTGG	Mycobacterium avium
TGAGCACGGTGAGATCCCGCTCGACGAGGCG	Mycobacterium avium
TCCGAGGTGTCTTGGTGATGCGCAGCGGCCT	Mycobacterium avium
GCTACGCGGTGCTCGCGCTGGGCGACTCCAA	Mycobacterium avium
CGCTGCTGGGCACCTGGACCGGCCGGGGCTC	Mycobacterium avium
CCGGGCTGCGGCTGCTGCGGCACGCGCACGA	Mycobacterium avium
GCGGCCCCAGATCGTCGGCGTGTTCACCGAC	Mycobacterium avium
TGCCCGGCGTCACACCGCAGATCGGTCAGGG	Mycobacterium avium
GGGAAAGCAGCCCCGCCCGGCGATCGGGCCG	Mycobacterium avium
GAGGCCGCCCGCTCCTGCAGGCCGAGCCGCC	Mycobacterium avium
GCGGAACCGTGGCTCGTGGCCGGGAAGTTCG	Mycobacterium avium
GGCGCGGCTTACTCCCCGCGAACGCGAGGTT	Mycobacterium boenickei
ACTTCCACAACGGATGGACCCTCACGCTCGA	Mycobacterium boenickei
TGCCTCGAACACCGCACGAACCGCCAGGTCT	Mycobacterium boenickei
CACCGTCGGCTCCAGCTGACCGAGCCGATCC	Mycobacterium boenickei
CGCAACCGACGGCGCGCGCGATCTCCACGGC	Mycobacterium boenickei
GGTCTTCACGCCGCGTCGCATGCTGGCAGTC	Mycobacterium boenickei
CGGCGGCGACGATGGCTCTGCTCGGCTACGC	Mycobacterium boenickei
CCGATGGCGTCGGTCAGGCAGTTCCAGGTCA	Mycobacterium boenickei
CACCGCCCAGTGGATTGGAGCTTCCGCAGGC	Mycobacterium boenickei
AGTTTCCGGGGTGAAGTACGCGGTGTTCAGC	Mycobacterium boenickei
CTGGACGAGCCGAAGAACACGGCATCGGTCA	Mycobacterium boenickei
AGACCAATCGCGTCTTCCGGGCGCGGGTGGT	Mycobacterium boenickei
GGCAAGCAGGGGAGTGCTGACGGGCAGACTG	Mycobacterium boenickei
AAGCTCAACAGGCCACTCCACCGCCAAACTG	Mycobacterium boenickei
AGCCGATCGGCGAAGTCAGCCTCGACGACTG	Mycobacterium boenickei
CCGCGGCGAAACTGCTGGCGATGCGCGCCGA	Mycobacterium boenickei
CGTCTCCGATCGGGCTCGACCCGAGCGCGGG	Mycobacterium boenickei
CTGGCCCGCGAGCTACGGGAGGAACTGGGCG	Mycobacterium boenickei
GTAGAGCGCGAGCAGCACCGCGATGGTCAAC	Mycobacterium boenickei
ATCGCCGAATTACGCGCGGGGACAAGAAAAG	Mycobacterium boenickei
AGTTCTGGATCACCAACCCCGTCGGCGAATT	Mycobacterium bohemicum
GGTTGCCGTGGCCGTGCTGGGCCACCGTTCG	Mycobacterium bohemicum
CGGCGAAGTGGGCGAGCACCTTGGCGTGGGC	Mycobacterium bohemicum
GAGATGGAGGTGCCCGCGGGGCCGATCGCGC	Mycobacterium bohemicum
TGAGTTCGGCGTCGGCGACGGGACGGAGAAC	Mycobacterium bohemicum
GCCGATGAGGTAGGAGGCCTGCGACAAACAA	Mycobacterium bohemicum
CGCGCAGCCGCCCTCGGACGTGGTGGCGCAG	Mycobacterium bohemicum
AACCAGCCGTCGTTGAAGCTGATCTGCTCGC	Mycobacterium bohemicum
CAGAGGCGATGTCGAAGCGACGCTGAGGCAG	Mycobacterium bohemicum
CCGACCGCGGCGACCACGGGAAGGTCCGACA	Mycobacterium bohemicum
AGCACATGATCCGCGTCAACACGGTGCTGCC	Mycobacterium bohemicum
CGTCAACGGCGTGGTGAGCCGCACGGTGCGG	Mycobacterium bohemicum
GCCCGTCGAAGGCCTGATCAACGCGTTCGGC	Mycobacterium bohemicum
CCCGTTGATGCTCTGAGCGTCGCGGATCTCC	Mycobacterium bohemicum
CGTACTGCGAGCAGTTCGCGGGGACCCTGAA	Mycobacterium bohemicum
CGCGGGCATCGCCGTGATCGCCGGCATGTTC	Mycobacterium bohemicum
TTGCTCAGTGAGCGCCGTTACGCCGTTCTGC	Mycobacterium bohemicum
CGTTCGCCGACCCCGAATCGCACTTCCATCA	Mycobacterium bohemicum
ACGTGCCGGAAGGCGGTGGGCGTGACCGCAT	Mycobacterium bohemicum
GCAACTGGGCACCGCGACGCGGAGCGGCCTG	Mycobacterium bohemicum
GTGTCGGTGCCGATGGAAACCGACCCGGGCG	Mycobacterium branderi
CATCACGGTGTCGACCGGCTGGGCGGGGTCG	Mycobacterium branderi
GGCCGGCCCACCACCGCCACCACCGGCGGCG	Mycobacterium branderi
AGCGGTGCGCCCGGATGCGCGGCTGATCCTG	Mycobacterium branderi
GCAGCGCCTGGTCGGTCATCACGTCCCCGGC	Mycobacterium branderi
GGCGCGATCCGCATGCCGGTTGCCGACATGC	Mycobacterium branderi
CTCGGCTTCGACGATCGTGATCTGTCCACCC	Mycobacterium branderi
ATGTCGATGACCTCACTGCCGAAGCGGCATC	Mycobacterium branderi
CCGAGGCCGGCGACATCCCGTTAGGACACAC	Mycobacterium branderi
GTCGCGGCTGGCGCTCACCACTCGGGAACCT	Mycobacterium branderi
TTGGAAAACGTGTTGGCGAGCACGGCCAGCG	Mycobacterium branderi
GGTGTGGCTGACCACCGCCGGGCCGAACGGC	Mycobacterium branderi
AGCCAACCCGCGCCGCACCACCTCGACTTCG	Mycobacterium branderi
TGACTGGCCTCGCTTCGGAACAAGTGCATGA	Mycobacterium branderi
CACCGGCGGGCCGTTCACCGCACAGATCACC	Mycobacterium branderi
CGGCGCGGTGGGCCGCCCCGTCGATTCCGTA	Mycobacterium branderi
CAGCGGTTTGCCGCCGAGATCGTCACTGCCG	Mycobacterium branderi
GAAACGTCGACGACCGAGGGTTCACCGGTGC	Mycobacterium branderi
GGCATTACGCTCGCCACCATTTCTGGGTTAC	Mycobacterium branderi
CGACAACCTGGAACTCAGCGACGACGACGTG	Mycobacterium branderi
ACCAACCGGCCGCGCGCCCGGATCGCGTCGA	Mycobacterium brumae
CGCGGTAGACCAGCACGCCGGGGATGTCGGC	Mycobacterium brumae
CGTCACCGCACTGCTGCTGCCGAGCACTCCT	Mycobacterium brumae
CTGGCCGCCGGATCGGCCGCCCGCTGGGCGT	Mycobacterium brumae
ATTCGTCGAGCACCAGGTACTGCAGCGACTC	Mycobacterium brumae
CACCCCGTCGGGCTGACGCGGCGAACGCGGA	Mycobacterium brumae
AGGGCGAGTTGGGCCGCGCGCTGGTGCTGCA	Mycobacterium brumae
TTGAACCGCTCCCCGGTCCGCAGCGCGCGCG	Mycobacterium brumae
TTTGATGCTTGCTGTGACCGGAGTCACGTAG	Mycobacterium brumae
CATTGAGCAGGCGGCTCAGGTGGTCGCGCTC	Mycobacterium brumae
GAAACCGACCTGACCGGCAACCGGGCCACCG	Mycobacterium brumae
GCTGATCCGGCCGAGCAGCACCAACGGGATG	Mycobacterium brumae
GCTGACCGTGGCCAGCCCGTGCCAGTCGTCG	Mycobacterium brumae
CGACGGCCTCTACGACGGCGATCCGCGCAAG	Mycobacterium brumae
CGCCGACACGCTGCGCGGGGAGGTCGCGCGC	Mycobacterium brumae
GGAGAACCGCATATCGTTGGTGTCCAGCGTG	Mycobacterium brumae
TCCGGCGCGACCGTTTCGGTGACCTCGACCA	Mycobacterium brumae
CCGATGATCGGAATGAACATCGCGTATTTGT	Mycobacterium brumae
CGAGCACGCCGGCGGGATGACCGCCGCGCAG	Mycobacterium brumae
CGCCGATCGCGATGAACAGCAGCGGCAGCGC	Mycobacterium brumae
GAAGCTCTACTGTCTTTTGCTAAGAGCGGCC	Mycobacterium canariasense
CCGAGCAGAAACGCACGCTGCGGGTCGTCGA	Mycobacterium canariasense
CCGGTGGTGGGGTCACGCTCGATCAGGGGCT	Mycobacterium canariasense
AACAGCACCGCCGTGGCACCGAGCACCGCGC	Mycobacterium canariasense
ATGGCGTCGAGCATGCGCGTCGCCTCCTCGA	Mycobacterium canariasense
GCCGCCGACACCATCACCTCCGGCCTGGAGG	Mycobacterium canariasense
ACGGCGCGCACCTCGGGCGACGGGGTGCCCG	Mycobacterium canariasense
CCCGCTTCGGCATCGGTGCCGCCGACGGCGC	Mycobacterium canariasense
AGCAATGCGGGCACCGGCTGTTCGGCGCCGG	Mycobacterium canariasense
TGGTTTCGTCGGCAACCCCGTCCGCGACTCC	Mycobacterium canariasense
TGCCGGACCGTACACATTCGTGGCCGCCGAC	Mycobacterium canariasense
GAGTCACCACCACACAATGCGAAGCCTGTCG	Mycobacterium canariasense
AAGGTCTGTGGCACCGGTTCTGCGCGGGTTT	Mycobacterium canariasense
ACGTCAACGGGATCGGCGCACCGGGCTTGTG	Mycobacterium canariasense
CCGGCGCCGATGGGCACGGTGGCGTCGGGGT	Mycobacterium canariasense
CATGTGGGGCGAGGCGCTGGCGATGTCGGTC	Mycobacterium canariasense
GGAACGACGCCACCAACGCCAGCACGCCGCG	Mycobacterium canariasense
CTGCGTGACGGCGACGACGTCCTTGTCCTCG	Mycobacterium canariasense
GCCGGACCACGAACTTGGTCAGGCCCGCGTC	Mycobacterium canariasense
TACCGCGGTGGGGCACACCGGAGGAGATGGC	Mycobacterium canariasense
CGTGCCTGTCCATCGACGACGCGGGCAAGCA	Mycobacterium celatum
GCAGATCAACGCCGCGCGGCGTCAGCTTCTC	Mycobacterium celatum
GCGGGCGTAGCCCGCGCGCGGACGATGGGGT	Mycobacterium celatum
TGGCGTTGGGCAAGCTGGGCCTTCAGCCGGG	Mycobacterium celatum
AGTAGCGCAGCTACTTATTGTCGCCGCCGCC	Mycobacterium celatum
GCTAGCGGTGGTAGTGCCCGCTGGTGCCCGG	Mycobacterium celatum
CGTGACCTCGCGCTCGGTGCCGTCGGACAGC	Mycobacterium celatum
TGACGTTGCCCATGTCGGTGCTGCCCACGGG	Mycobacterium celatum
GGGTACACGACAGCTATGAGGCGCTGATCGT	Mycobacterium celatum
TCGGTTTGACGGCGGTGACCTTGCCGATGGT	Mycobacterium celatum
CGACACCACCCGCTGGGTCGCCACCCCGGCG	Mycobacterium celatum
TGCGGGTCTGTCGACTGGAAAAGCCCAGTCC	Mycobacterium celatum
GCTGTCGACCGGGCCGGACTACGAAGCCCAC	Mycobacterium celatum
GACGCGCGGGAGAGCCGTGGACGGCCATAAC	Mycobacterium celatum
CGCAGCTGGGATCAGCCCGCGGTGACCGCGG	Mycobacterium celatum
GGGTTTCTGTTCGGCGGCGTCATCTACGACA	Mycobacterium celatum
AGGTTCAGTCCGCCGAGGACGCCTGGAACAC	Mycobacterium celatum
AGTCGGGCGCCGCCGATGCCGTCGGCGCCGC	Mycobacterium celatum
GAGGCCGGCCGCTCGGCGACCCTGCGCGCCG	Mycobacterium celatum
ATCCGAGCAGCTCGTGAAGCAGCTGCACTCG	Mycobacterium celatum
GCGCCGTGCCCCGTCGAGATCAAAAAGCAGA	Mycobacterium celeriflavum
GATGGATCCGGGGAGGCCTATCTGATCGGCG	Mycobacterium celeriflavum
GGCTCGAGCCGAGGGCATCGAGATCCGCATC	Mycobacterium celeriflavum
CTCAACAGTTTGGTCGAACGGGAAGATGGAG	Mycobacterium celeriflavum
CACTAAACCGGCGGTGGCGATCTCGCTCACT	Mycobacterium celeriflavum
CGGGGTCCTCGGACCGCATCGCCCAGTACGC	Mycobacterium celeriflavum
CCAGGCCGCCGTCGACCAAATAGCCGAGATC	Mycobacterium celeriflavum
CAGCGCCTCGTCGGTCACCGACCCCTGCTCG	Mycobacterium celeriflavum
GCGTTCGTCGCGGTTCGCCGAACCGTAGAGC	Mycobacterium celeriflavum
CCATGACCGTCATCGACGACAACTACACCGG	Mycobacterium celeriflavum
CTTGATCATGCATCGGTCGGGTCCGACGAAG	Mycobacterium celeriflavum
ACGACGGTACGGTACTCATTCGCTGGTTCCC	Mycobacterium celeriflavum
GTGGAGGTTGCCGGACTGTTCATCAACGCTG	Mycobacterium celeriflavum
TCGACCGCGAGCGCGACGGTGATCAGCGAGT	Mycobacterium celeriflavum
GCATGCCTCTGCCCCATGTGAGGTAGATGGC	Mycobacterium celeriflavum
TGCAGACCGCGGCGGCGCACATCGCCGCGGG	Mycobacterium celeriflavum
GGTGACAGCCGCCCGGCGTCTTCACCACCCG	Mycobacterium celeriflavum
CGTCCTTGCGGCCCGCGTCGGAGGTCTCGCA	Mycobacterium celeriflavum
GGATGTGGATCGCCTCGCGCAGCGCAGGCGG	Mycobacterium celeriflavum
CCACCTCGGCGGGCTGCTGCGGGTTGTCGCT	Mycobacterium celeriflavum
TCCGCAAGGAAGAGGAAGTCGAACAGGCCCT	Mycobacterium chelonae
CCGGCCCAGGTGTCGTTGATGAGGTCGGCGC	Mycobacterium chelonae
ACCGGTGCCGCATAGCCGACGGGGAAGTTCG	Mycobacterium chelonae
CGCCCTAACGCGACGTCTTATGGAATTCCCG	Mycobacterium chelonae
GTCTGGGATGTGAGCAATCCCGACAAGTTCA	Mycobacterium chelonae
AGTCTTTCCTGAGCGCACTGGAACTCCAGTG	Mycobacterium chelonae
GCATGATCAAGCGCGCCGATGCCAGCTATGG	Mycobacterium chelonae
GGGACCTGGGCAGGCATCGCGGTGAGCCGGT	Mycobacterium chelonae
CTCGACGTTCGGCGCAAATCCGATGGCTTGC	Mycobacterium chelonae
TTCGCGAAGGGCTCCGTGCAGTTGCGTCAGC	Mycobacterium chelonae
CACTCCGGGCACCCGGATCGGTAAGAGCTTC	Mycobacterium chelonae
CTGCTCGAATTCGTACTCCCAGTTGGGCAGT	Mycobacterium chelonae
TAATTGACTGGTAAGCGCTTCGGCCTGGGCG	Mycobacterium chelonae
GATCGCGCCACCGCCCACGCGGTACCGGGTG	Mycobacterium chelonae
TGCCGGATTCCGGGCGACCGGATCATCGGCC	Mycobacterium chelonae
TGTTGCCGGCATGCTGCATGTCCGAAGCGAG	Mycobacterium chelonae
AGTGCCGGCGCCAGCGCCGTCGAGACGCTGA	Mycobacterium chelonae
CCTCCAGCGGGTGCGCACACGTCACGTGGTC	Mycobacterium chelonae
GATCGCCGAGGTCCGTGGTCTCGCACCGGGC	Mycobacterium chelonae
GGGCATTGGTGCCCGATTCCTTGGCCATGGC	Mycobacterium chelonae
GCGACGTCGATGACCGCGCGGACCTCCTTGA	Mycobacterium chitae
CCGAGGCGGGCCGCGGCGGTGATGGTCAGGC	Mycobacterium chitae
CGGGACCAGCGCGAACGCCTCGGCTGTGTAG	Mycobacterium chitae
CCTGCGCGTACAGCCCGACGCTGTAGCCCAC	Mycobacterium chitae
CAATCAGGTGGGGCTGGCCGATGTCAAGCGC	Mycobacterium chitae
ACCTCGGTGTCGGCCGTGGTGAACCGCGCCG	Mycobacterium chitae
GCGGGTCGCGGCCTTCTCTCGTCGCCGCAAC	Mycobacterium chitae
GCTCGCGGCAGCGCTCGGCCAGATCGTCCTC	Mycobacterium chitae
AGAACTTCCGGGCCGCCTTCGACGGCTTCGA	Mycobacterium chitae
TCAGCGCGGCCGCCAGCGCCGCGGAGTCGTC	Mycobacterium chitae
ACCGTCGAGCGCCGCGGCGCCGGGCCCCTGC	Mycobacterium chitae
GCCCCGGGGATCTCCTCCAGGTACCAGGAGA	Mycobacterium chitae
ACCGCGACGATGGCGGCACATACCGCGACCA	Mycobacterium chitae
CGCGAGGAGCACCGCGCCGCGCAGACCGCCC	Mycobacterium chitae
ACATGGCTCTGGCTTGACGGTGAATTCAAGG	Mycobacterium chitae
CGAACGCGTTGGGGTTGGGGTAGCGGTCGTC	Mycobacterium chitae
GGCCGGCTGGGCCGGGGCCGGGGGTCGGGCC	Mycobacterium chitae
CCGCCGGCGGACAGCGCGCCGGCCGGGGTGT	Mycobacterium chitae
GCGAGATCGCTGCTGTGCGCCCAGCGGATCC	Mycobacterium chitae
GGGTCACCACGATGGTCAGCATGGCCGTCGG	Mycobacterium chitae
GGGAGGCCAACATCCCGGCGATCGAGGTGAT	Mycobacterium chlorophenolicum
TGTTCTGGCCGCTGATCCACACTTCACCGAT	Mycobacterium chlorophenolicum
GACTCACCGATCGCTTGGGCGAGTGTGTGCG	Mycobacterium chlorophenolicum
CCGGTGACGCCGCGGCCGTGGCCATCGCGTC	Mycobacterium chlorophenolicum
GTGGACTGGCACGGCGACGGGATCGAGACCT	Mycobacterium chlorophenolicum
CCTGGCCAACCCCGCGCTGACCAGCCCCGTC	Mycobacterium chlorophenolicum
GCCCGGATGATCGCTCGACCGAACTCCGCAA	Mycobacterium chlorophenolicum
ATCGGGCAGATCGCCACCAGCGTGCTGTCGG	Mycobacterium chlorophenolicum
GGCCAGGATGCCCGCCCACATCATCAGCACG	Mycobacterium chlorophenolicum
GACCTCGATCACCTCGCGGATGTCGATCGGC	Mycobacterium chlorophenolicum
CATGGGCTCCATAGATACCGGTCGGGTCCGA	Mycobacterium chlorophenolicum
TTCGCAGCGCCTCCAGCGCGGCGTGACTGAT	Mycobacterium chlorophenolicum
CGACACCCGCGCGGCCGTGCGGATTGCCGTG	Mycobacterium chlorophenolicum
TTCGCCGACCAGTGGGCCCCCGACGGATCGA	Mycobacterium chlorophenolicum
ACCCGAGGTCTGCTTGGCCGCCCGCAGGCGC	Mycobacterium chlorophenolicum
GGTTGTGCCGCCTGCCCGTCTGCCGGACCTC	Mycobacterium chlorophenolicum
CGCGCAGGCCCCGCCGCAACTGGTGCCGCCC	Mycobacterium chlorophenolicum
CCGTCTACCTCGCCTACGCCGACCACCGGGG	Mycobacterium chlorophenolicum
GGTCAGCGACTTCGCCGGTCACGCCGCGATC	Mycobacterium chlorophenolicum
AGCCAGCTGCCCGACATCGCGGCCGTGCGCG	Mycobacterium chlorophenolicum
GATCGATCGTCTGCATCAGCGCTTCGGCGCC	Mycobacterium chubuense
GCGGCCGAGCCGGATCTTCGGTCCCTGCAGG	Mycobacterium chubuense
GAAACGGGTCGGCGGGATGGCCGCGAAGTCC	Mycobacterium chubuense
ATCCCGATGACGCGGGCGGGCGCCGGGACGC	Mycobacterium chubuense
GTGGCGCAACACACGTTCACCAACAGTCGCG	Mycobacterium chubuense
GCAGGAGTCACGGCTCCGTCGGGTCGACCGT	Mycobacterium chubuense
AGGGTCTTTGGCGATCTGCGCGGGTGGCATC	Mycobacterium chubuense
GAGCTGCGGGTCCCGATCGGTGTCACCGCGA	Mycobacterium chubuense
GCACCACGGGTGCCAGTCTAACCGCCGCTCA	Mycobacterium chubuense
ACGCGGTTGTCCAGAGCGTCGGCGCCACACT	Mycobacterium chubuense
GCCGACGATCTGGCCGTCCGGACCGTGATAG	Mycobacterium chubuense
CTCGATGCACAGGGATTCGTCGATGGTGACC	Mycobacterium chubuense
CGGGGAAGCTCACCACCCGATAGCGGCCCAG	Mycobacterium chubuense
ATGGTTGCGACCGTGGCGCGTACTTCCGCCC	Mycobacterium chubuense
CACCACGATGAGGTCGGCATCGGCCAGAGCG	Mycobacterium chubuense
GTGCTGTTCGTCATCCCCTGGGGCCGACACT	Mycobacterium chubuense
TGGCCATCACCTCGACGCCGACGCCCGACAG	Mycobacterium chubuense
TTCGGATCGTCGACGTTCCGCTACGCCGCCC	Mycobacterium chubuense
AGCCCAAGGTGCTCGTCGCGGCCGACGGGTA	Mycobacterium chubuense
GTGCCCACCGGCACCGTCGATTTGATGGTGA	Mycobacterium chubuense
CGATCGCCCAGTCCATCCATGACGTGGTGGC	Mycobacterium colombiense
GGCCTTGATGCCGATGTCCATCCCGCGCAAC	Mycobacterium colombiense
CCGCCAAATTCAACAACGACAACTCGGCTCA	Mycobacterium colombiense
ACCAGGGTGTTGAAGACCCCGACGCGCAGGT	Mycobacterium colombiense
ACCAACCCGTCGTCCTTGAGCCCCCATCGGA	Mycobacterium colombiense
CGTCGGCATCGTCATCGTCTTCCTGGCCTGC	Mycobacterium colombiense
AAGGTGCGTGACCACCCGGACTTCGCGGCGG	Mycobacterium colombiense
ATCCACCTCGAGGCGCTGGGCAGCCTGATCA	Mycobacterium colombiense
GCCCGGTCCAAGCTGCGCCTCGGTGACCATC	Mycobacterium colombiense
CTTCCACACCGGCTTGGGGATCCGGCGCGGT	Mycobacterium colombiense
GGCTTGCTGACCGACGATGAGATCGACACGA	Mycobacterium colombiense
ATGGCCCAGGCCGACGTCGGCATCACGGGCC	Mycobacterium colombiense
CAGGTAGATCTCGCCAAGCTGCCCAAGGACT	Mycobacterium colombiense
CCCGGCAGCCAGGTCACCTGGTGGACGGGCG	Mycobacterium colombiense
CTTTGATCTCGGACAGGCTGATCAGCGCTTC	Mycobacterium colombiense
AAGCTGGTCACCGATCGGCCCGACTACGTCT	Mycobacterium colombiense
CGAACCTCGGCGGGCACCTGCTGTGAGTGCA	Mycobacterium colombiense
ACGTCCGCCGCTGCGGCGTGCGCCGAGGGCT	Mycobacterium colombiense
CGCATGCCCGAATCGATCCGCGTCGCGGTCG	Mycobacterium colombiense
CTGGGCGACTCCGCGGCCGTCGCGCACTACA	Mycobacterium colombiense
AGGCACCGCGGGGGAGGTCATCTTCCCCAAT	Mycobacterium colombiense_B
ACCGTGTTTCTGGCCATCCTGGACACCGACA	Mycobacterium colombiense_B
GCGCTCGGTGCCATACGACTGCTCGGCGACC	Mycobacterium colombiense_B
ACGCGCAGCGCTATCTCGCCGATCGCTGGGC	Mycobacterium colombiense_B
GCCCTTGGCCCGGGCGTCCTTGAACGAGGGC	Mycobacterium colombiense_B
TCGGGCATCGTCATCACGACCTTGCCGACGT	Mycobacterium colombiense_B
GCGACGCTGTTCGTGCTCTACGCGGCGGCCA	Mycobacterium colombiense_B
CGAGCCGGTGCGCCGGCTCCTCGCGCATTCC	Mycobacterium colombiense_B
TGGGCGGATCGGGCGCGATCAACGGCGGTTA	Mycobacterium colombiense_B
CCACGGCGCGACCACCTCGTTGATCGACTAC	Mycobacterium colombiense_B
CCGCCGCGGGAACGGTCATCGTCGACCAGGA	Mycobacterium colombiense_B
GCATTGCCGGCGAGCTGCGCCAGGCCGACGT	Mycobacterium colombiense_B
GACAACCTCCGCCGACCAGCCCGCACCGACG	Mycobacterium colombiense_B
GCATCGTCGGCGCGCATCCGGCCCAGTAGCG	Mycobacterium colombiense_B
TGACGGTGCGCACCCGCGGCGTCTGCGACGA	Mycobacterium colombiense_B
ACGCGGGCTCCGATCCCTACAGCGAGCGTTG	Mycobacterium colombiense_B
TCCCGGGCGAGGACGATCAGCTGGCCATCAT	Mycobacterium colombiense_B
GCACCGCCGCGCGGCGCGCGGTGAATCCCAG	Mycobacterium colombiense_B
TACGGGTTGCCGCGCACGGCGTTCAAGCCGT	Mycobacterium colombiense_B
GTGTCGACGACCGCGACCCGTTGTCCGGCGC	Mycobacterium colombiense_B
AGACCACCGTGGTCTGCGGTTGTGGACACAC	Mycobacterium confluentis
GCAGCCCCGCGAGCTCATGGGCGCAGACCGC	Mycobacterium confluentis
GGCCCCGCCGGTTCGCGTGCGGCGATGCCGG	Mycobacterium confluentis
CCGGTTGCACACCATCGCCCGCGACTCCTCG	Mycobacterium confluentis
GCTGAGTCGCGCCGACTCGGCTTCGATGATG	Mycobacterium confluentis
GTTGGGCGGATCATCACGAAACGGATTGTCG	Mycobacterium confluentis
GATCCCGGTGCGGATCTACCGCCCAACACCG	Mycobacterium confluentis
TGTTCACGGTCGCGGTCGGCGCGGCTGTGCA	Mycobacterium confluentis
TACTACGTCGGCGTCAGCGCGGGCCGGAAGA	Mycobacterium confluentis
CACGCTGCCGGATCCGCTGGACACGGTCTTC	Mycobacterium confluentis
CACCGACGTCAACGTTTCACGTGGAACTACG	Mycobacterium confluentis
GACCACGACGACGGCCCCGCTGGCGCGCAGG	Mycobacterium confluentis
CGGGCGCAGCGATCCCCGCGGCCGGACCCCG	Mycobacterium confluentis
CCAGGGTGATGCCCTTGAGGACCTTGAGTGC	Mycobacterium confluentis
AGCACGTCGCCGCCATTGCCGATGCCCGCGT	Mycobacterium confluentis
ACCACGTCGGAGGTCTGCTCAGCGACGCGCT	Mycobacterium confluentis
CCTCGACCTTGTTGCGCCAGAACTCGGAGTT	Mycobacterium confluentis
TGGCTGCGCGGCGGCGACATTGTGGTCGTCA	Mycobacterium confluentis
CGGAGATGCGTGACCGGCCCGGCCATTTCGG	Mycobacterium confluentis
GCCAGTACTGAGTTGGCGACAGGCTGCCCGA	Mycobacterium confluentis
TCTCGCCGGTGGGTACAGCCTCTTCGGGCGC	Mycobacterium conspicuum
GGGTCGCCGACGTGCTCGGGATCCCCTTCTA	Mycobacterium conspicuum
GCATGCAAGCGCGAGACGGTCGAATCCTGCT	Mycobacterium conspicuum
GGCCAAGTTCGTCGAGGTTGACGGTACCGAC	Mycobacterium conspicuum
TGCTCGGCATCGGGATCCCGGCCGCGATCGG	Mycobacterium conspicuum
GCAGTCGGTGGATGGACTGGCGTTGGCCGCC	Mycobacterium conspicuum
CAGCCCAACACCCACGAAGACGCCGACTACG	Mycobacterium conspicuum
TGATGCCGGCGAAGGAGTCCACTCCGTCGAT	Mycobacterium conspicuum
CGGCGCCACCGCCAATTTCAGCCCGGGCAGA	Mycobacterium conspicuum
AGGCCGGCGCCGCCGCCATCTACCCGCCCGG	Mycobacterium conspicuum
TCATCTCCTACCTCAAGGCCCGGGCCGAAGC	Mycobacterium conspicuum
TGGAAAGCCTGTCCACGGTGCGGCTGTCCGA	Mycobacterium conspicuum
GCGGCGGCTCGGTCCGGGCCGGCGACCAGGC	Mycobacterium conspicuum
GTGGCCTGATGCGACTGGTAGAAGCCCTGCA	Mycobacterium conspicuum
CGAATCGTTATCTCCCGGATAGGTCCGCGTC	Mycobacterium conspicuum
GTGGTCGGCGCGCCGGTGGTCGAGCGCTCCG	Mycobacterium conspicuum
GCCTCTCCGGCGGTCCCGATGACCTCCTCAT	Mycobacterium conspicuum
TTCGGTCCGCCGCCGACCCGCTGGCCGGTTA	Mycobacterium conspicuum
TCGGCGCTGACCGAGATTTCCTTGACGGCGC	Mycobacterium conspicuum
AACACCCCGCACGGGTGCCCGTCGACCATCG	Mycobacterium conspicuum
GGCAGCGGAGCACGCGGTGAGTGCGGCAGCA	Mycobacterium cosmeticum
CGAGCCGATGGTGCTCAACCACAGCCGGCCG	Mycobacterium cosmeticum
GGGTTGTCCGCGGTGAACGCCGAGCCGAGTG	Mycobacterium cosmeticum
GACGAGTTCGGGGCTGTAACCCAGCGCGCGA	Mycobacterium cosmeticum
GCGGCCAGCACATCCGCGAGGTCGTCACGGC	Mycobacterium cosmeticum
GGTGCGGGGAGCGGCCCGCTATTTCGGATCC	Mycobacterium cosmeticum
TGCGCCGGGCGGAGTCACGGGCCCGCGACCT	Mycobacterium cosmeticum
CCGTGGTTCAGCGCGCACACCGCCGAGCAGA	Mycobacterium cosmeticum
GCCCAACAGTGCGGTCACCACCGGGTCGGTG	Mycobacterium cosmeticum
CCTGACGTGACTGCGCTTGGCGCTTCCGGAA	Mycobacterium cosmeticum
CGGGCGGCCGCCGGCGCGATCACGATGCTCA	Mycobacterium cosmeticum
ACACAGCATTACGTGCGGTCGCAGAACGGGA	Mycobacterium cosmeticum
GACAGCAGGCTCCTGATTCTTGAAACGCGAC	Mycobacterium cosmeticum
GACGACGGCGCCGTCCGGCCCGGGTAATCCC	Mycobacterium cosmeticum
GCCGACGGCTCGTTCAGCTACACCCCGACCG	Mycobacterium cosmeticum
GCGTGGTGGATGCGATCGCTGCGCGCGCCGG	Mycobacterium cosmeticum
ACGCAGCGCCGGGTCGTCACGCAGCGTCTGG	Mycobacterium cosmeticum
GCCCCCACCGGTTCGGCGAACACCGGCTCGG	Mycobacterium cosmeticum
AGAGCGGCCCGGCCGGCTTCGGCCAGGAACC	Mycobacterium cosmeticum
CCGCCCGTGGACTGGAACAACCCGGGTGGTT	Mycobacterium cosmeticum
TCATCTTCTACTTGCCTGCTGCTCGTCTGAG	Mycobacterium diernhoferi
GCGGACGTGGTCGACACCGCCCTGGCTCAGG	Mycobacterium diernhoferi
CGACGGCCGCAGCCTACTGGTCGAGCAGCCG	Mycobacterium diernhoferi
CGAAAGCATGGATGACCGGGCATAATCCATC	Mycobacterium diernhoferi
GGAGTTGGACGCCCCATAGAACGCCTCGGTC	Mycobacterium diernhoferi
CGCCCATCCCGACGCCGATGTGGATGCCACC	Mycobacterium diernhoferi
CCGCCGAACGTGGCTGGGCGGTGGACGATCG	Mycobacterium diernhoferi
CGACCTCTGCTTGGGATACCTGGATCAGGAC	Mycobacterium diernhoferi
GCAGGATGGCGGTGATCTTGTCCAGCCCCCC	Mycobacterium diernhoferi
GGTTGAAGATTTGAAACCGGATCGCCGGATA	Mycobacterium diernhoferi
ATCGGCCAGGACGCCGGTGCGATCCGCAGCT	Mycobacterium diernhoferi
GGCTGAGGTACTCCGCATCGGCATCGGCGGA	Mycobacterium diernhoferi
CGTGGCGGAGCGCGGTGTGCTGCTCGCCGAG	Mycobacterium diernhoferi
TTGCACATGTGATCCCAGTACTGCTCGAACT	Mycobacterium diernhoferi
CTGGACCGTGAGATCGGGCTGGCGGTGCGGG	Mycobacterium diernhoferi
CGACCACTTCTGGAAATGGAAGGGCAGACCG	Mycobacterium diernhoferi
CCGGGCCGCATCGTGACCGGGGTGGATGACC	Mycobacterium diernhoferi
GACACCTTGATGAAATCCTCGGCAGCGCCTT	Mycobacterium diernhoferi
ATGGGGCTCAATCGATATCCGCCCGGTCCGC	Mycobacterium diernhoferi
CGCTGCAGCGGGCGCCGGCGAATTACCGAAA	Mycobacterium diernhoferi
CCGTCGACCGGCGGACTGTGCAATTCCTCAC	Mycobacterium doricum
ACCTGTCGCGCAACGCGGAGTGGCAGGATCG	Mycobacterium doricum
GCTGCGGGGTCGTGGATCTCGTCGATGGCGT	Mycobacterium doricum
GAGCAGACCGGGCAGGACGTCGACATCGCTC	Mycobacterium doricum
GGAGCGACTCGCCACCGGGCTGCTGGACGCT	Mycobacterium doricum
CGGCGCCCGGCCCGTGCTGCCCGACATCCGC	Mycobacterium doricum
CAGACCGATGCACCATGCCACGCTGACCCCG	Mycobacterium doricum
GGAGCAGTAGACGCCGTGCAGCAGTAGACAC	Mycobacterium doricum
GTGATCGGCTCGTCGCTGGAGGTGAGCTTCG	Mycobacterium doricum
CTGAAGGCCGCCGGGGTGCGCGCGACGACTG	Mycobacterium doricum
GCGCGAGCGGCGCTGCCGCCGCACCTGAGCG	Mycobacterium doricum
CGCCGAGGGGCTGGAAACGCTCGAACAGCGC	Mycobacterium doricum
GCGCCTCGCTGCGCATCAGTTCGAAACGCTC	Mycobacterium doricum
TTCGACCCGTCGATGTCCGAGGTCGTCTACG	Mycobacterium doricum
GGTCGACGCGGGGCGCCGCGTCGGCGGTCGC	Mycobacterium doricum
TGGCCGTGGTCGTCGTTCATCTACTCGATCA	Mycobacterium doricum
GGGGGCGCGACTGTCGGTGGTCGTGGACGAC	Mycobacterium doricum
CAGCGCGCCAGCGCGTTGCTCGTCGTCGGCC	Mycobacterium doricum
GCTGGTCGGGCGGTGTAAGCGCGCCCGGGTG	Mycobacterium doricum
CGTCACCCGGGGCGACCACATCGATCGTCTC	Mycobacterium doricum
CCACCGCGGCCACCGTTGCGTAGTAGAAGCG	Mycobacterium duvalii
TGGCCGGCGCCCGCCTGTACTTCTGTCCGCA	Mycobacterium duvalii
ATGAACTAGGCGAAGTTTTACCGCCGGAGAC	Mycobacterium duvalii
AAGTCCGAAACAACCGGGGAGACCTCGGCGG	Mycobacterium duvalii
GACCCGAGGCCGCCACGGCGGCGAAGCTCTT	Mycobacterium duvalii
GATCCGGTTCCACCGTGATCCGCCCGGCCTT	Mycobacterium duvalii
CCAGAAACGCCACCGAGACGCCGATGATCTC	Mycobacterium duvalii
CGAGGCACCGGTCGAGGAGACGCTGCGCTTC	Mycobacterium duvalii
TTCGCCACCGCGGTAGCGCATCACGCCGTGC	Mycobacterium duvalii
CGCGTTGCCGGCATCCAGCGATCCGAACAGC	Mycobacterium duvalii
CGTCGCGGCAGCGGTCCTGCCACTCGGGGTT	Mycobacterium duvalii
CGCTGCGGAAGGCGAAGACCCCCGAGGTCGC	Mycobacterium duvalii
GCTGATGTTGCCGTGTCTACCGGTGGATGAA	Mycobacterium duvalii
TTTCCCGACACACAGAACCGGTTGCATCTGG	Mycobacterium duvalii
CAGCGTCGCTGCGGTCGGCGACGGCACCCAG	Mycobacterium duvalii
CGCGCAGCGCCTCGGTTCGGGTCGGCACGTA	Mycobacterium duvalii
GGATCCGGCGCGCCGACGGCAGGCATGGTCT	Mycobacterium duvalii
GCAGCATCCATGTGGCGCCGCCCCCGGGGTG	Mycobacterium duvalii
CAACGGGTCGAGTTCCGAACAGGTGATCATC	Mycobacterium duvalii
TTGAAATCGTCGAGGTCGACCAGCGCAACGA	Mycobacterium duvalii
GCACGCGCCCGACATCATCACGGTGGCCGCG	Mycobacterium elephantis
ACACGACCCACCGTGCTGTCGGCAGGGGCCG	Mycobacterium elephantis
CCTGGTACGAGGTGTCGAACTGGTGCCGGCC	Mycobacterium elephantis
CGAGCAGGGCCGGCCACCGGATCCGAATCAT	Mycobacterium elephantis
GCGTTGCTGGCCGCTGCCGTCGAGCCAGACG	Mycobacterium elephantis
CGTTGTCGCGCCAGCGGGCCTCACCGGAGTA	Mycobacterium elephantis
CTGGATGGGTTATTTCGCGGCCCGGTCGGCC	Mycobacterium elephantis
GGGTAACGGCGACTACGCTCGACGAAATGCG	Mycobacterium elephantis
GAGCGAAGCCAGCGGCAACGGGTTCACGTTC	Mycobacterium elephantis
CCGACCGCCCACAGCGACTCCACCGCGGCGG	Mycobacterium elephantis
TGGCGACGGGGACGGCTCGGCGACGATCTGG	Mycobacterium elephantis
TCGGGGCATCACAACTGTGCGGGGAGGTGCC	Mycobacterium elephantis
GTGTTCCGATGGCGTTCGTGCTGGCCCGCAG	Mycobacterium elephantis
CGGCAGGCTCCCTGCCATTTGCGGGGGCTTT	Mycobacterium elephantis
TCGCTCAAGCTCGGTGCTGGGCACGGCTGCT	Mycobacterium elephantis
TCAGGCGCGCGTCAGCGTGGCGTAGCGGGTC	Mycobacterium elephantis
CCGCGTCGTCGAGGTCGTTCAGGTCGTCCTC	Mycobacterium elephantis
GGCATCCCAGGTCAGACCGAACTGCGACAAC	Mycobacterium elephantis
GAACACGTCGTGTGGCCCCTCGAACGTGAAG	Mycobacterium elephantis
GGTCGGGGAACGCGAATGCTCGATCCAGCGC	Mycobacterium elephantis
ATAGATGCCCAGCCACGCCCGCACCCCAGGC	Mycobacterium europaeum
ACCGTGCTCGAAGCCGCACACGGCGATCGAG	Mycobacterium europaeum
GCGGGCGCGCATGTCGTTTCAATGGCGCACA	Mycobacterium europaeum
TGATGTTGGCCGTTGCCGGGTGGGCCCGCTA	Mycobacterium europaeum
GCGACCTCGACGACCGCCAGAGCCCCATCGC	Mycobacterium europaeum
TGCCGAAGTTCTTGCAGGGCCTGGGTTTTGC	Mycobacterium europaeum
GCCAAACTCATGCTCTGCGACGTCTACGGGG	Mycobacterium europaeum
CGCGCGGCGCGGCGCTCGGGGCATGGCGCAT	Mycobacterium europaeum
ACGCGCGGCGGAGACCGCCGGAAGCGACCCG	Mycobacterium europaeum
TCGCCGTCGCACGTCCCAGGGGGCCAATGGC	Mycobacterium europaeum
TGCCCCTGTCCGGTCCCTTCCGCGTGACGGC	Mycobacterium europaeum
TGCACCCACCCGTCACCCAATGACGGATGCA	Mycobacterium europaeum
GAACGTGAACTTGCGCGCCCCGTACATCTTG	Mycobacterium europaeum
GGGGCACGCACGCCGCGCTCCGGCCAAGCGG	Mycobacterium europaeum
GCACCGCGGCCTCGGCACGCGCCTGATCGAA	Mycobacterium europaeum
GGCCGCAACCGGTAGCCTCTTTAAGTTGTGA	Mycobacterium europaeum
ACCCAAGGGATGTCGAAATCCGCGGTCGGCG	Mycobacterium europaeum
CGCCGCGCCCTGAGCGCGTGGGAGCTTTCGC	Mycobacterium europaeum
CAACCTAGAGGGCCTAGTCGGGGCCGAAAGT	Mycobacterium europaeum
TCGAACGCCGCCCGGGGCGTGCGCCGTCGAG	Mycobacterium europaeum
GGCGGGTTCGGGCGCGGTCAAGGCGCTGCCG	Mycobacterium europaeum_A
GTTGTCGCGTTCACGGCGTTCGACGCGAGCC	Mycobacterium europaeum_A
CGCCCCGCGGCGGCCCGGCGCGCCGCCAAGG	Mycobacterium europaeum_A
CGCGGCGCCGGATCGCCGCGACGCCACGTCC	Mycobacterium europaeum_A
TCGCGCCGCAATGCGCCGAAGACATCGAGGT	Mycobacterium europaeum_A
GGTGCCGAACGTGGCTTCCATCCTGATCATC	Mycobacterium europaeum_A
TAGTCTCCAAGAGTTCACGTGCGCGGTCGAT	Mycobacterium europaeum_A
CCCGCGACGGTGCCACGTAATCTGACTCTGA	Mycobacterium europaeum_A
GGCGCTACCCGCATTCGTTGTTGGCGGCCGC	Mycobacterium europaeum_A
GCCGGCCGGCGAAGCGTTCACGACGACGACC	Mycobacterium europaeum_A
CGGCCTACGCCGAACAAAACGACTCGGGCGA	Mycobacterium europaeum_A
GCCCGGGTTCAAAATGCCCTGCGGATCCAGC	Mycobacterium europaeum_A
ATACCTACGGCCTGATCCGGTTCGGGTCCAG	Mycobacterium europaeum_A
GCGGCCAATTGGTACGTGCCGGGGATCCCTT	Mycobacterium europaeum_A
CCTGATCGCGCTGGTCAATACCCTGAACCTG	Mycobacterium europaeum_A
CCTGCTCATGCCGCCGTCCTGCAGCGCCCGC	Mycobacterium europaeum_A
CGGTGTTCATGATCGGCGGCGCGCTGGGAGC	Mycobacterium europaeum_A
CGGCTCCCGACACCGCAGGCGAAATGGTGGT	Mycobacterium europaeum_A
GATGCAGTTCGGCAAACAGGACTGAGTCGTC	Mycobacterium europaeum_A
GGCCGTGTATCCGATCATGATCCGGCAGCGC	Mycobacterium europaeum_A
CGGCGTGTGGTTCCGGACCGTCGAATTCGCC	Mycobacterium fallax
CCGGCTGGCGCTGGAACAGGGCAAGGCCGCC	Mycobacterium fallax
CGGACGTCGCCGCCCTCGCGGCGATCCTCGA	Mycobacterium fallax
ACCGGTCACCGCCAGCTCGGTGCCGACCTCG	Mycobacterium fallax
GGAACAGGAACTGCATGGCGACCATGCCGAT	Mycobacterium fallax
TTTGTTCCTTCACCGCGTGCAGCCCGGCCGA	Mycobacterium fallax
ATCCGCGGGGTCCGGCCGTGGAACAGCATGT	Mycobacterium fallax
GAAGCCGAACATCGCCGCCGCGGTGCCCAGG	Mycobacterium fallax
CCGTCGCGCGGGGCGCTGGCGCACATCGCCG	Mycobacterium fallax
GCAATCGCAGCGCCACCCGGTGATGCTCTAT	Mycobacterium fallax
AGCAATTCCTGCTGGTGCAGGAAGAAGCCGT	Mycobacterium fallax
AGGCCGAGCGGCTGGTGGAAACCGGCTTCGC	Mycobacterium fallax
GGTGTGGATCGCCGTCGACATCGGCTTGGTC	Mycobacterium fallax
CGCGGGCCGGGCCAGGGTGGCCGGCAGTCCG	Mycobacterium fallax
ATTACTACGCCACCAGCGACCCGGACACCTT	Mycobacterium fallax
GGCCGCGCTGGGCGCGGCGGGCGCGTTCCTG	Mycobacterium fallax
TGCGGCCGCCCAAGCCGCCGCCCACGCCGAC	Mycobacterium fallax
ATCACGACAGCGAGGGCGGCGGGACGGCCGG	Mycobacterium fallax
TCGACGACGTCGAGGAGGCCGACAGTCAGCT	Mycobacterium fallax
CTCAAGACGTACTGGCCCGAGCGGTCGTGGC	Mycobacterium fallax
GCCGTAGGGGTAGACCACCTCCTCGACGATC	Mycobacterium farcinogenes
CTGGCCTCGTTGAGGCACGACAACGGGCCCG	Mycobacterium farcinogenes
TCATCTGGCGTTCCTCGCCGACATCCGGGAG	Mycobacterium farcinogenes
GCTCGAACTCGCCGATCGCATCACCGCCAAC	Mycobacterium farcinogenes
CGAACCGCATCTTCTCCAGCACCGCCGGAGC	Mycobacterium farcinogenes
GCGCCCTGCGGCGGTTCACGGTGATCAGTCG	Mycobacterium farcinogenes
CCGAGCGAATCCGGGTTCCAGCGCCAGTACC	Mycobacterium farcinogenes
TCGGTGGCCAGCTGCCGGTAGCTGAGCCCTG	Mycobacterium farcinogenes
AATCGTGCCATCTGCGCGAAGATCGGATATC	Mycobacterium farcinogenes
CATGCATCAATCGCACGGTCAGCGGACTGAG	Mycobacterium farcinogenes
GACGGTGTCCGCGACGGACCTAGAGGACCAC	Mycobacterium farcinogenes
CGGGCCGAGACTGGCCGGGGCGTTGGGCACC	Mycobacterium farcinogenes
AACCGGGTGGTCAGGGAAACCTGCTGCCCGG	Mycobacterium farcinogenes
GCAGCAGCTGATCGGCGATCGGGTCATCGCA	Mycobacterium farcinogenes
ACAGCGGCAAGCCACCCGGCAACTGCCGCTT	Mycobacterium farcinogenes
GGCAACACCGCGCAGCGCTGCGACGGAGGCG	Mycobacterium farcinogenes
GTTCAGGCCGCCTTTGGTCAGCGAGGCCAGC	Mycobacterium farcinogenes
TTGTGCGGGAACAGGTTGAACTGTTGAAAGA	Mycobacterium farcinogenes
ACCTTGGGCGCCCCTGACAGCGTGCCCGCCG	Mycobacterium farcinogenes
GTTGACCACCGCCGCCAGGGCGCACACCGGA	Mycobacterium farcinogenes
CGCTCGGTGGCGTCGGTCTCATTGCCGTGCT	Mycobacterium flavescens
GGCGGATCACCGGCGACTACTTCAAGGGTCC	Mycobacterium flavescens
GGCCCAGTGCTCCGCCAGGTATTTGGTGGCG	Mycobacterium flavescens
GACAACGCACTGTTCGTGCTGCCGGTCAGTG	Mycobacterium flavescens
GAAGGAGCGGGACCGGCTCGCCGCACAGCGC	Mycobacterium flavescens
GGGCCCGCCCGAACCAGCCGTCGCCGCAGCA	Mycobacterium flavescens
CCGACGGAAGAAGAGAAGTCGCAGTGGTACT	Mycobacterium flavescens
GGGGTCGAGCCGCTCGGTGATGGTCACGACG	Mycobacterium flavescens
CGGAGACCTATACGGTGGCCCAGCTCGGGCA	Mycobacterium flavescens
AGTTCGCCCACGAGGAAGAGCAATACGAGCC	Mycobacterium flavescens
GCCGTCTGTGGGGATTTCGAGAAGCACCTGG	Mycobacterium flavescens
GCCTCGCTCGAGCCCTCAAGCCACCCGTTCG	Mycobacterium flavescens
CGCTGCGCAGTCCGCGGCGCGGCCACCGCCG	Mycobacterium flavescens
TGACCCGCCATCTCGAGCAGCACGCCCCGTG	Mycobacterium flavescens
AGATAGTGATGCGCCTCAGCGGCTTGGCGGA	Mycobacterium flavescens
CGCCGATCGCATCGCGACCATCACCCTGAAC	Mycobacterium flavescens
AGAACGACTGCTCGATCGGTTTGCGCTCCGG	Mycobacterium flavescens
CCGCGCGCGGGCCGCCCCTTCCCCGCCGGGC	Mycobacterium flavescens
GAAGCTGAACGTCGAATGGCCGCAGCGAGGT	Mycobacterium flavescens
GCGAAGCGCCTGGTGCTGCTGGCCGACATGA	Mycobacterium flavescens
CGGCGTCGCGAGTGCCGTACATGTGCAGCAT	Mycobacterium florentinum
ATCACCAGATTCATGACCGCTTGGACAACCG	Mycobacterium florentinum
CGCCGATATGAGGTGGCCGGTTCGGGTCCAG	Mycobacterium florentinum
AACTGCATGGCGTCGGCGTTGACGATTTCGG	Mycobacterium florentinum
GAGCTTGTCCAGCAGCTCCGTCGGCACGTGC	Mycobacterium florentinum
GCCGCACCCGCTCCGGCGACCCCTGCCCCCG	Mycobacterium florentinum
CCAGGGAGCGATCCGCAAGTCCGGCAGCAAG	Mycobacterium florentinum
CGTCGACGGCCAGCCGCATCGCGGCCGCCAT	Mycobacterium florentinum
CCGGATGTGGTTGCGAGACCCGGCGCCGTTG	Mycobacterium florentinum
GACTACCAGCAACTGGTGCTGGTCCGCCAGA	Mycobacterium florentinum
CACGCCGTCGGCGTAGGCGCCGATCTGGGCG	Mycobacterium florentinum
CCCATACGCCTCCCTCTTACTGGTGAGCCCA	Mycobacterium florentinum
GTCCGTGTTTGTCCATGAATACCCCGGCGAG	Mycobacterium florentinum
CGGGCGATTTCGGCGGTGGCCGACGTCGAGA	Mycobacterium florentinum
TCACGTCCCAGCCGGTGTAACCCCGGGCCTC	Mycobacterium florentinum
GGTCGATGCCCGGATGCGCCGGTTGATCCGC	Mycobacterium florentinum
CCCCGCGATTGCCACGTCATCTTGCTCGACG	Mycobacterium florentinum
CGGGCGGCCAACCGAAACGTCTTCTTCTCGC	Mycobacterium florentinum
GAGCAAGGAACCACAGATGACCGTATTTGTA	Mycobacterium florentinum
ACACCCAGATGCCGCCGGCCTTGAGCATGTC	Mycobacterium florentinum
AACAACACCGCGCCGAGGTACTGGACGAACC	Mycobacterium fluoranthenivorans
ACGGTGTCGGCGACTTCCTGCTCGAGCTTGG	Mycobacterium fluoranthenivorans
TCGCGCACCTCATCGCGCGTGGGGCGGGTCC	Mycobacterium fluoranthenivorans
GCCTCGGTGGCCCGGCAGAGTCCGGAAGCGG	Mycobacterium fluoranthenivorans
CGACGAGCAGACCCATCCGTCGGGCCTCGCT	Mycobacterium fluoranthenivorans
GACCTCGGCCGCAAGCCGTTCGAGGCGTGGC	Mycobacterium fluoranthenivorans
TTGCGGGCGCCATGCTCTGTCTGCACTTCAC	Mycobacterium fluoranthenivorans
TGACCGACGCTGTCGATGCGGCCCGTGCGGC	Mycobacterium fluoranthenivorans
TGGCGCACCTGGAGGCCTTGGGTTTGCGGGT	Mycobacterium fluoranthenivorans
ACGGTGGGGCCGGACGACACCGCGAGGCTGG	Mycobacterium fluoranthenivorans
CGCTCCGCACGCCGGTCGGCAGGATGGGCGG	Mycobacterium fluoranthenivorans
GACGTTGTACCCGATGGCCCAGCCGAGGTTC	Mycobacterium fluoranthenivorans
CGCGGCTTCCTCGATGGCCTGGCGTCCGTTC	Mycobacterium fluoranthenivorans
TCGGTGGACAGCGCGGTGACCACCGACCCGA	Mycobacterium fluoranthenivorans
CGGGCGACGCGCCGCGCAAGTGGTGGCAACC	Mycobacterium fluoranthenivorans
GGCGACGAAGGCGAGCAGGCCGCCGACGTAG	Mycobacterium fluoranthenivorans
GGGGACGCGCACGCCGCGGGACAGCGCCCGG	Mycobacterium fluoranthenivorans
GTGTCCTGGCTGCGCATCAACACGTTGTAGC	Mycobacterium fluoranthenivorans
CCGGCGCCGTGTCCCACCAGATCGGGTCGTA	Mycobacterium fluoranthenivorans
GCGATCCAGAGCATTCCCAAGGGTCAGTGGG	Mycobacterium fluoranthenivorans
CGATCGTGGGGATCACGCTCGTCGGTATCGC	Mycobacterium fortuitum
TCGTCGTCGGTCACATCGAGTTGGACCACGG	Mycobacterium fortuitum
GACAACCTGTTCATGCTGTCCCTGTCCCGCG	Mycobacterium fortuitum
AGCCCTGGTCGTGCTGGCGCTGGTGTATCTG	Mycobacterium fortuitum
CACCGAGAGTTCACCGCGCTTGGAACTGATC	Mycobacterium fortuitum
ACGGCACATCCAGGAATTGTTCGGTGATCCG	Mycobacterium fortuitum
CAAGCCATCAGCTTCCTCAGCACTCGCGGTG	Mycobacterium fortuitum
AGAACTATGACCGCCGTGGTTCGGGCACAGT	Mycobacterium fortuitum
AAGCCTGGACCATGAGATCGACGCCCGATGC	Mycobacterium fortuitum
GTGACGAACAAGACCACCGCTGAGCTGCTGG	Mycobacterium fortuitum
GCTCGGTGGCATGCACGCCTTCATCTGTCAC	Mycobacterium fortuitum
CCACCGCGAGCTTGGCCGACCAGGCGTCCCA	Mycobacterium fortuitum
ATTGAAACTTCCGCCAAGAGGAATGTGAAGC	Mycobacterium fortuitum
ACCGACGGTGATTTTCGCAAGCGCCACCACC	Mycobacterium fortuitum
GACGTTGCCGCTGCTTCTGTTGCGGGGCAAT	Mycobacterium fortuitum
GGTCTCCATACGGCATCGCCCGTATGACATG	Mycobacterium fortuitum
CCGCGGCCGCCAGATCCTCATCGGGGCGAAC	Mycobacterium fortuitum
GGACGCATCCCGCGGCCCCACGTCAAATAGA	Mycobacterium fortuitum
GCGCGGCTGCCCGGTTTCACCACCGACAGTC	Mycobacterium fortuitum
TGGGGGTTCCGGTGGCGTCGGCGTCACCCGC	Mycobacterium fortuitum
TTGAGCATCGCCTCGAGCTGCGGCCGGTCCT	Mycobacterium franklinii
TAATGCAATCGTTAGTTAGGAGATGGGAATG	Mycobacterium franklinii
TACGGCTCACCCTGGCCACCCAGGAGAACGT	Mycobacterium franklinii
TTACTGAGCGGGCCCACCCCACGATCCAGAT	Mycobacterium franklinii
ACCGCATCGAGGCCACCAACCAACGCGCCTT	Mycobacterium franklinii
AGCGCATCCTTGTCGGCCACGTGGCGGTACA	Mycobacterium franklinii
CGGCTTCCTTGCGCAACGACTCAGCCAGTTC	Mycobacterium franklinii
AAACCCACAACGTCAAGCTTCTGCATGACGA	Mycobacterium franklinii
CGTCGCAGGTTAGGTAATACCGAGCAGCAAT	Mycobacterium franklinii
TATCCGGACGAGCGGCGAACCGCCGCGGAGC	Mycobacterium franklinii
CGCGTTGCGGCCCTCGAAATGCTTGCCCAGC	Mycobacterium franklinii
ACGGACAGGATGTGCGTGGGGACGGCACCCG	Mycobacterium franklinii
CGACGCGGACTTAACGAATTCGCCCTGATCG	Mycobacterium franklinii
GCTACCTGGACAGCGTGCTGGAGTCACACGG	Mycobacterium franklinii
CACCGACTTCTCCCACAGCTGTGCCGCCAGC	Mycobacterium franklinii
GCGGGAAGTTGCGTCCCCGCACGATGAGCAT	Mycobacterium franklinii
CCGAGCAGGCCGAGGCCCTGATCGCCGCCGA	Mycobacterium franklinii
GGTGGGGGTAGCCACTGGTGGCGGCGGGAAC	Mycobacterium franklinii
ACAAGCAGGGCGATGCCGGGTTGGTCCTCGC	Mycobacterium franklinii
ACGGTGCCCAATACCTGGGTCGCCGGTTCGT	Mycobacterium franklinii
ATGAACCCGACCCCGATGCCGTTGGCGATCG	Mycobacterium gilvum
CGCGCTGGAACGCGACGACGCGCGGCTCGAC	Mycobacterium gilvum
GTCACGCAGGTCGACGCCGTCGACCAGCACG	Mycobacterium gilvum
GCAACTGCGCGACACCCATGTCGAACTCGAC	Mycobacterium gilvum
CCGTGCTCTACCCGCGCCGCCTCGGTAAGCC	Mycobacterium gilvum
CGTACACGTTCGTCGACTACGAGGCCGACCC	Mycobacterium gilvum
GAATAACGTTGCCACCAGCCCACTTTCACGC	Mycobacterium gilvum
GCCTGGGACACCAGATAGGCGCCGACGTACC	Mycobacterium gilvum
GGACGTCGCGGCAGCGCATCGGCAACGCCGT	Mycobacterium gilvum
ATTCGTCGACCGGTCCGGCGACGGTGTCGGT	Mycobacterium gilvum
CAGGTAGAAGGCGCCGTCGAGATGTACCTCC	Mycobacterium gilvum
CACATGGAGTCCGCCCATCGCGACGTCGTCG	Mycobacterium gilvum
ATCCGGCCGTGAGCGCCTGGAACTGGCTCGA	Mycobacterium gilvum
GCTCGCGGCGGCGCGCCTCGTCGAGGGTCCG	Mycobacterium gilvum
CGGACCTCGCCGATGCCCTCCGCGCGCGTCT	Mycobacterium gilvum
CTGCTGGTCCGGGCGACCGAGGCGCGCCGGC	Mycobacterium gilvum
CACCCCGACGCTCGATCCGCTTGCCGCGCAG	Mycobacterium gilvum
CTGGTTTAATCTGTCGTCTGGTCGCCGAACA	Mycobacterium gilvum
GAACGGACCGAAACCAGCCTCGAGTGGGGTC	Mycobacterium gilvum
ACCCGCAGCGGCGGGTGCAGCAGCCCGCGGT	Mycobacterium gilvum
CGCTTCGAGCCGGGCATCGACGGATGGCTCA	Mycobacterium goodii
AGGACTGTTCGGAGAGCAGTCCGAGCAGTGA	Mycobacterium goodii
GGCCATGCCGCGCTCCAGCGGCAGATTGTTA	Mycobacterium goodii
GCGGTGTACATCGCCGTCCAACTGGCCTACT	Mycobacterium goodii
CTCGGACGCGAACTCGGCCCGGACGCGCCAT	Mycobacterium goodii
AGACCTATTTCGGTCCCACCGGCAAGGGTTT	Mycobacterium goodii
AGGGAAATGAGGCCTGCATCTGTACCTGGCA	Mycobacterium goodii
CTGTTGTGTGTGCTCATTCCCTGGACAGCGG	Mycobacterium goodii
ATGTTCCTGACCGATGCCGAACTGGTGGCGG	Mycobacterium goodii
TCAGATCGGTGAGGAACTCGCGCCGCTCCTG	Mycobacterium goodii
GTCGCTCGGGGTCAGCAAGCTCTTCCAGAAG	Mycobacterium goodii
CCGGGTACCCGATCACATCGAGCTGGCCCTC	Mycobacterium goodii
CGCTCGGTGCGGGTAAGGGGACGCCCGGCTT	Mycobacterium goodii
GAATGGTCGCGGCCAATTGCTCGGCCTTCTC	Mycobacterium goodii
AGCACGGCTTCGACGCGATCGATGGTCCGTA	Mycobacterium goodii
ACGGGGCCCGGATGGTCGTGACGGTGCTGAG	Mycobacterium goodii
TGAGCAGCAGCGCCGTGGGCGCAATATCTCT	Mycobacterium goodii
CGTCGAGGAGGCCGCACGCGAGGCGGGGTTC	Mycobacterium goodii
ATGTCCATTGACATCTTCTCATCTCCTTCGG	Mycobacterium goodii
GTTCGGCGCTCACCGACCCCGACCACCGCGT	Mycobacterium goodii
CGCGGCCGGCGCGGCGGCTTCCTCCGTAGCC	Mycobacterium gordonae
GAGCAGGTCACCTATCACGTCGGTCGGCACC	Mycobacterium gordonae
CCATCTACGACACCTCGCCGCTGCAGCGCCG	Mycobacterium gordonae
GTGGAGCCGCGGCGCCGGTGGAACCGTGCGG	Mycobacterium gordonae
TACCAGCAGGACACGCGCATCGTCGGCGAAG	Mycobacterium gordonae
CGCCGCCTAGGCCACCGTTCCCGCCTGCGCC	Mycobacterium gordonae
TGAGCAGAATGTGCCAGGACACCACATCGAC	Mycobacterium gordonae
CTTCGGCGCTGCTCGGCGGTGACGCGCCCGC	Mycobacterium gordonae
CGATCAAGGTGTCATGGCCGCCGGTCGCCAC	Mycobacterium gordonae
GATCGATGATCTGCATCGCCTCTTCGAGCCG	Mycobacterium gordonae
ATCCCTGCGGGACAGGACTTCACCTATCGGT	Mycobacterium gordonae
TCGAACTTGCTCATCGCAGGGCCTCCACCGG	Mycobacterium gordonae
GTTCCTGGAGATCGGCCCGCACCCGGCGCTC	Mycobacterium gordonae
CTGTTCGGCCAGTTCGACCAGTGCGATCACG	Mycobacterium gordonae
GGTGAGGTGGGCCGCCGCGAGGGCGCCCATC	Mycobacterium gordonae
CCGAAAGGGCTAGACTGCTACCCAGAAGAGC	Mycobacterium gordonae
ATGACGAATCTGCTGCACGCCCGCGGCCAGC	Mycobacterium gordonae
GGGGCGGCGCTGGGGCCGCGGGAGGCCGAAT	Mycobacterium gordonae
CGGTGTCCTCGTCGCCCTGGCCGTGCTGGCG	Mycobacterium gordonae
TGCGGGATGCCCGCCGCTTCCAGGACGGTCG	Mycobacterium gordonae
CGACACCGCTGCCGACCCGTTGATCCCGCGC	Mycobacterium grossiae
GGCAACGCCGAGGCGGGGGAGGGCGGCACCG	Mycobacterium grossiae
TCGACACCGACTCGCTGCTGGTCAGCCAGCC	Mycobacterium grossiae
GGCGAGCAGCAGCCCCACGCCGCCGCACGCG	Mycobacterium grossiae
GACTCCCACCGAATACGACGCCTCGGCGCTG	Mycobacterium grossiae
GCCGCCGCGCCGGCGGCCACCGCCGGGGGCG	Mycobacterium grossiae
TCACGCCGAACGAAACGCTGGTCCCCGTGGC	Mycobacterium grossiae
CCGTCCGGGCGGTATCGGCGGAGACGACGCG	Mycobacterium grossiae
AGGTTGCCGGGCCCTGGTGGACGGCGACGGG	Mycobacterium grossiae
GTGTCCGGCCGCGCGGCCGGATCCACGAAGA	Mycobacterium grossiae
CCTCTTCACCTCCGGCACGACGGGCCGCAGC	Mycobacterium grossiae
GCTGCCACCAATCCTGCCGTCTTGCAGGGTA	Mycobacterium grossiae
TGCCTCCCGCCGATTGATTGCCGCGGGCGTG	Mycobacterium grossiae
GGTGAGCACCGCGCCGACCTCCGGGGACGAC	Mycobacterium grossiae
TCAAGATCAGCGACGACCGTCGCGGATCTGG	Mycobacterium grossiae
GGCCGCCGAGCAGGCGACCGCCGCGGCCTGG	Mycobacterium grossiae
CGAGCACGTGCCGGGTGCCCTCGACGTTCGT	Mycobacterium grossiae
GCGTCGAGCGTCACCGCGTCGAGTCGCTCGG	Mycobacterium grossiae
CGTCGACGACGAGGACGCCGAGGACCTCGAG	Mycobacterium grossiae
GTGCAGGACGAGTGGACCATCACCTACAAGT	Mycobacterium grossiae
GGATGTCATGGCCATCGAGCGGGTTTTCTCT	Mycobacterium haemophilum
ATACAGCAGCAGGGGGTTATCTCGACCGTCA	Mycobacterium haemophilum
CACCGCCTCGCCGAACTCCTCGAGTGTCGGA	Mycobacterium haemophilum
GGCGCCACCGCCCCGGCACTCCCTTGAGTGG	Mycobacterium haemophilum
GGACCGCAGCTACCGGCAGGCGGTCACGGCC	Mycobacterium haemophilum
TCTGGGCGCTCGGCGTTATCACACCACCGGG	Mycobacterium haemophilum
TGCCAGCATGTTTCAGTGGCTGTGAACACCC	Mycobacterium haemophilum
TTTGGGCGAGATGCAGAAACCCGTACCCGTT	Mycobacterium haemophilum
CAACCCGATGGTCGAATAGTTAACCCGGATC	Mycobacterium haemophilum
GATCACGCCCGCGTCGGGCGGCACCACCTCG	Mycobacterium haemophilum
AGTCGCCGACCGGCTCCGCGCGGGTGTTCGG	Mycobacterium haemophilum
TAGGATTTGGCGCGATGCGTCGTCGGCGACC	Mycobacterium haemophilum
CGTGGTTGACCGACGGTCGGCTGCACGCCCC	Mycobacterium haemophilum
GTAGTTATCAACCAGCGGTGCACCATAGCCG	Mycobacterium haemophilum
CTGCAGACCGTCGTGCGCCACGACTATCTGG	Mycobacterium haemophilum
TCCTTGAGGTGTTTCACGCCGAAGAGCAATC	Mycobacterium haemophilum
TCGATGGATTGATGCTGTCGGTGGCGGTGCA	Mycobacterium haemophilum
TCCGGTCCTGCTAAGCGGCCCACTGTATTCC	Mycobacterium haemophilum
CGGCAACGAGAAATTACCTTCAAAGAAAACC	Mycobacterium haemophilum
CGGGCCCCGACCAGCAGGGCCAGGTTGACGC	Mycobacterium haemophilum
CACCCGGAATCTGCGCACGCTGGAGAAAGTG	Mycobacterium hassiacum
AGGTGTGCGTGCCACCGGAAGTCGAAGACGC	Mycobacterium hassiacum
CGCCGACGTGATGTTGCGCGGGGTGAGGATC	Mycobacterium hassiacum
GTAACCGGATATCCGCGACATGCCGTCGGGC	Mycobacterium hassiacum
CACGTTCGTCAAGACCGAAAACACTCAGCTT	Mycobacterium hassiacum
CGGCCTCGGCGCGCAGCCCGTCGAGGTCCTT	Mycobacterium hassiacum
TTCACCGATCCCGATGAGTTCCGGCTGGACC	Mycobacterium hassiacum
GGTCGTTGCCCTCGCCGGCGAACGCGGCCTG	Mycobacterium hassiacum
CGACCGTCCGAGATTCAGCCACAGTTGATCA	Mycobacterium hassiacum
TCGCGGTCCACTCCCGCGGCCTCCAGCACCG	Mycobacterium hassiacum
CGCGGGCGCGCCGATGTACCTGTGCCCGCAG	Mycobacterium hassiacum
GTCGGCGAGCTTGAACGCGATGGCCTGGAAC	Mycobacterium hassiacum
CAGCCGGTACGGTGCGGCCGCGGAGTGGTCG	Mycobacterium hassiacum
CTGTCGGCGATCGCCGCCGGCGGGCCGTTGC	Mycobacterium hassiacum
GCGGAAGTCGGTGCGGACGTGCTGATTGCGG	Mycobacterium hassiacum
TTCCTCGCCGCGCAGGCCGGCCTGGTCGACG	Mycobacterium hassiacum
GGTTGACCTGCCGGCCGATCCGCGCTGGGGC	Mycobacterium hassiacum
CGAACTCGGCGTCGGTGGAGTACTCGGGTTT	Mycobacterium hassiacum
TGAGTGAGCGCGTGCCGCGCCCGCGCGAGCA	Mycobacterium hassiacum
ACCACGATGGACTTGAACGTCAGCCCACTCG	Mycobacterium hassiacum
ACCGCGACTCGATCGTCGAATCTGAGCTCAG	Mycobacterium heckeshornense
ATGCAGCTCTGGGCGCCCTGACCGCGCTGCG	Mycobacterium heckeshornense
GAACACCTCAAGCCTTTCCACACGCTCACCG	Mycobacterium heckeshornense
GCCGCCTGGAATGACATAACACCCCTGGCGC	Mycobacterium heckeshornense
ATCGGGTCCGGCGTGCACGATCTGCGGCTGG	Mycobacterium heckeshornense
GGCGTCGCGGGCGGCGCCCAGCACACCGGCT	Mycobacterium heckeshornense
ATCACCGATGACCCCGAGGCGCTGGCCTCGG	Mycobacterium heckeshornense
GATCAGCCGGATCGCATGATCGGTCCAGCCG	Mycobacterium heckeshornense
CGCGGGCCTCGGGATCGGCGAAGTTGGGTGC	Mycobacterium heckeshornense
CTCCCAGCGCGTCGCCGAGATCGCGTGCCAG	Mycobacterium heckeshornense
CCAAAGCACGGTCAGCAAGGACCGCCCCGAC	Mycobacterium heckeshornense
TTATCCCGGGTGGCCATTTCGCATCACCCCT	Mycobacterium heckeshornense
TCGCGTGTTCGTTACTGCGTCCGCCGTAAAC	Mycobacterium heckeshornense
ATACCGAAGTGCTGTCCAACTTGCGGGTGCT	Mycobacterium heckeshornense
GCGATCAGCTGCCGGGCGAAAACGAGCTCGA	Mycobacterium heckeshornense
TCCCGTCTTGAACATGCACCTTCCGATGGTG	Mycobacterium heckeshornense
GTCTTCGGGGGTGGCTTCGGCGAGGAAGTCA	Mycobacterium heckeshornense
GTACAGCGCTGTGACAACGCGCGTGACGCTT	Mycobacterium heckeshornense
AAACGTCACCGCGCACGCTTGCGCCGGCACA	Mycobacterium heckeshornense
AGCACCGTTACGCGTTTGCGCCGTTCGGCGG	Mycobacterium heckeshornense
ACACCACGCACGGCTGGTATCAAAGATCACC	Mycobacterium heidelbergense
GGCGAGGTAGTAGCGCGCACCCCGCAGATAG	Mycobacterium heidelbergense
CAAGAGCAGCTCCTCCAAGCCGTGACGGGCC	Mycobacterium heidelbergense
GCACACCTGGCTCGGTTTCGTCGACTCCGGC	Mycobacterium heidelbergense
CGACCATAGACCGCGGGCCGCAATCACGACG	Mycobacterium heidelbergense
GGGGTGACGGTGTCGGAGAGCGCTTTGGCGG	Mycobacterium heidelbergense
TCGCCCAGAACGCCGCGCACGACGCCGCCAA	Mycobacterium heidelbergense
ACCTCGGGAACAACCAGATGCTGGAGGTGGG	Mycobacterium heidelbergense
TCGAGGCGCTTGAGCGCGAGCATGGACAGCC	Mycobacterium heidelbergense
GGACGCGACGGCCGGCCTTGCGCTGAGCGTG	Mycobacterium heidelbergense
TGCATGCCAGTGCTGCTGCTGCCCTCAGTGG	Mycobacterium heidelbergense
CCGCGGAACTGCAAGACCGGCTGTTCGCCGA	Mycobacterium heidelbergense
ACCCCGGGGCCGGCGACGCGGTCCAGGCCGC	Mycobacterium heidelbergense
GTCCACCCACGTCAGCTGCACGATCGGCGGG	Mycobacterium heidelbergense
GCAGCCGGGCGGCCGTCAGCTGCGCGCCGCG	Mycobacterium heidelbergense
TGGCGGGCCGCGCCGTCCCGAAACCAGGGGT	Mycobacterium heidelbergense
CTGGTCGCACTGGCGATCGCCTTCGCGGTGG	Mycobacterium heidelbergense
CAGCGGCACCATGACGGTCACATCGGCGCGC	Mycobacterium heidelbergense
TGTACGCCGAGAAGAAGGCGGCGGCGAAGAG	Mycobacterium heidelbergense
CTTCTCGTCCCGCGTCCTCGATCGGCTTGTT	Mycobacterium heidelbergense
CAGGAACAGCCCGCCGGGGCCGACCGCGCGC	Mycobacterium helveticum
CCCGCCCAGCGCCCCAAGCACATGGGGATCC	Mycobacterium helveticum
CGGACACGCCCGCCGAAATGCTGGGCATGAA	Mycobacterium helveticum
TACACGATCAACTGCGACCTGCTGCCGAACA	Mycobacterium helveticum
GTTCGACGTCCCCGGCGTGCACGAACACGAA	Mycobacterium helveticum
ACTGCTCCAGCAACATCCCCGAGGCGCCGAT	Mycobacterium helveticum
CCGGTAACGGGTTTGACTACCGGAACGGGCT	Mycobacterium helveticum
AGTCGATCCGTTAGCTTGGACAGGTGTCCAG	Mycobacterium helveticum
TGCGTCGCCAGATCGTCGACGGCGAGCTTGC	Mycobacterium helveticum
GTCCGTTCCTCCGGGCGTGTGAAGACGAAGT	Mycobacterium helveticum
GAGGCAAAGACACGCACGTCGGTGCCGGCGC	Mycobacterium helveticum
TACCGCGACCCCGCCGCGGTCACCGATTCGT	Mycobacterium helveticum
GTTCGCGTTGGGTCTGCTGGCGTGGATGTAC	Mycobacterium helveticum
TGTGCGGGCGGATGGATGTTTGTCAGCGGGC	Mycobacterium helveticum
CAATTGCGTCACGGCGCCGATTGCCGCGCCG	Mycobacterium helveticum
TGAACCTCGCCCCCACGCTGCGGTGGTTCGC	Mycobacterium helveticum
AGCCGCTGCAGCAATTCGTCCTGAGACACCC	Mycobacterium helveticum
CCGCGTTGGCAGGTGCCCCGGCCGCCGGTCA	Mycobacterium helveticum
CCGTACCGAGGACTATCTTGCGGCCATAGCC	Mycobacterium helveticum
TTCCGAACAACTGCGCCGCTTCCTCGACGAC	Mycobacterium helveticum
TGGGCGTCACCGAGGCCGGCCCGGCTTTCCA	Mycobacterium heraklionense_A
ACCAGAAGGGTGGGCCCGTGAAGCCTAGGAA	Mycobacterium heraklionense_A
AGTGCAGAGGCGTCCACTGGGATCTCCTACG	Mycobacterium heraklionense_A
CCGACACGTACACACAACCGCGACGGGCCAG	Mycobacterium heraklionense_A
ATCTGATCGATCTCGACGCCTCCGTGTCCTG	Mycobacterium heraklionense_A
CGAGGACCCCGCGGTCTGCGATGTCGCCGTC	Mycobacterium heraklionense_A
GCGGGTCTGTCCGTACGGGATGGTCAGCAGG	Mycobacterium heraklionense_A
ACCGCCTGACCGGGTTCGGGCACCGACGGCA	Mycobacterium heraklionense_A
AGCCACACCGTGGCGGCACCGACGCGCAGCG	Mycobacterium heraklionense_A
AGCGGGTTCCGCCGGAGCAGATGACCGGTGC	Mycobacterium heraklionense_A
AACGGCAGTCCGGCATCGATATAGCTCAGGT	Mycobacterium heraklionense_A
GGCTTACCGCTGAAACGGTGTGCGATGTCGG	Mycobacterium heraklionense_A
CACCGACCTGGGGCAGCAACAGGCCATCGAC	Mycobacterium heraklionense_A
AACGGCGACGAGTCGGTGATCGGCGCGCAAT	Mycobacterium heraklionense_A
TGGACGGCCGATGTCAGTTTCTCCGGCGTGC	Mycobacterium heraklionense_A
CAACGCCGATGTCAGGGCCAATACCGCGGCG	Mycobacterium heraklionense_A
GCGAACGTGCACGGCGTGGCCGACCCGAACT	Mycobacterium heraklionense_A
GTCTGAGCTATGGCGAACCGCAGCCCCGAGC	Mycobacterium heraklionense_A
GCCCGGATGCGCGTTGGTGTTGCCGACGATG	Mycobacterium heraklionense_A
CGATGCTGCAGCTCGCCGTCGACAAGCAGTT	Mycobacterium heraklionense_A
AGCCCGGAGCGGCCGGCCCGCCGCCCACGGT	Mycobacterium hiberniae
CTGCTGGACGCCGGCGGGCTGGTTGTGGTGA	Mycobacterium hiberniae
GACCTCCGAGGCGATCCGGGAGCGGTTCGGC	Mycobacterium hiberniae
GACGCGACGGCCTGCGTGCGAAACCGCACCA	Mycobacterium hiberniae
CCGGCCGATGCAACGGGCGCTCCAGGCGGTG	Mycobacterium hiberniae
GGGCGCGACGGTCTCCACCTCGGCGCCGCGC	Mycobacterium hiberniae
CCTTTGCCCGGACAGCGATGCGCCGGTGGCC	Mycobacterium hiberniae
CGGTCCGATGCCGAGATCCCGGTGCCGATGT	Mycobacterium hiberniae
CGGGGGCTCGCCGACGGTGTCGATCACGGCG	Mycobacterium hiberniae
ACGCCGGCCCGGGGGGATAGCCCTCGAAGCC	Mycobacterium hiberniae
CGTCGCAGTCAGCCGCAACTCGCTGCCTCCG	Mycobacterium hiberniae
TCGTTCTTCAACGGCAGCGATCTCGACCTCA	Mycobacterium hiberniae
GCGGGCCGAAAATGTTTGCCCCGTGGCCCTT	Mycobacterium hiberniae
AGCCCGGTGACCTCGATGAGGCGCACGTCGG	Mycobacterium hiberniae
ACTGTCGCGGCTACAGGCGGCGGTACAGCGT	Mycobacterium hiberniae
TGATCACCCGCACCACGTAGTCCACCAGGGC	Mycobacterium hiberniae
AAGCACGACCGCCGCCATGACCACCACCGCG	Mycobacterium hiberniae
GTATGGGGGTCCTGGGGCCCACCCGGATGGA	Mycobacterium hiberniae
TGGACATCGCCGCGGTCACCGAGCTGGCTCA	Mycobacterium hiberniae
GCCGCTCATTCCCAGCCGGTCGGCAAGCATC	Mycobacterium hiberniae
ACCAGCCCGTCAAACAAGCAGACGACTCGGG	Mycobacterium immunogenum
GCGCGATGCCGGAATTCGGTGGGAGTCGTTC	Mycobacterium immunogenum
CCGTTCGCGAGGCGCTCACCACGCTGAAGGA	Mycobacterium immunogenum
AACCAAAGGCCGAGAACATGTTTCCGAACGT	Mycobacterium immunogenum
CCGCCATGGCTTTTCCCATGGCTCCAAGTCC	Mycobacterium immunogenum
GCCGCGCTGCGGTTCAAAGATGTTTATTCCT	Mycobacterium immunogenum
CACCTCGACGTGGTTGGGCACGACCAGTACC	Mycobacterium immunogenum
CGATCACTGCGGGGTGCTGGGGTCGTCTGGC	Mycobacterium immunogenum
GTCCTCCCGGGAGCGGTTCGCAGCCTTCATC	Mycobacterium immunogenum
GAATTCGGATCGGCATTCCTGGAGCGTCCCC	Mycobacterium immunogenum
GCCCATCAGATGGTGCATGCGTTCGTCGAGC	Mycobacterium immunogenum
AGCAGGCCGCGTCCTGGGACGAGCTGCCCGA	Mycobacterium immunogenum
CCGCCCCGGAGTCGGCGGACCGTCCAGGTTG	Mycobacterium immunogenum
TCATACGTTCGTAGAAGACGCTGAGCTACCC	Mycobacterium immunogenum
ATGGTCAGTGCCAGCTCGTCGGCGGTGATCT	Mycobacterium immunogenum
AGCTGTTGATCACCAGCTGCTACCTGGGGGC	Mycobacterium immunogenum
ATCGCTTCATCGAAGGTGAACTGCGGCCCCG	Mycobacterium immunogenum
GGTGAAGGTCGGCAGCTGCGGCAGAGCATCG	Mycobacterium immunogenum
GTTGGTGCGGCCGGGGTTGCCGATACGGCGG	Mycobacterium immunogenum
AATTACGCACGGTGCAGCGGGTGGTGGACCA	Mycobacterium immunogenum
GCGCCACCATGCCCTCATTGGGCTCGATGGT	Mycobacterium insubricum
CGACCGCCTCGCCGCGCCCGCATCGTGATCT	Mycobacterium insubricum
TTATGCGACGCTGCTCGCCAAGGGTGAGGAC	Mycobacterium insubricum
GCCCGGAAATTTTCCGGGCCCCTGACCGTAC	Mycobacterium insubricum
CGAACGGCACCTCGATGGCCCGGGTGATGCT	Mycobacterium insubricum
GGCGTGCGGCTGCTCAAAGACGGCCACACCC	Mycobacterium insubricum
ACCCCGGTCACCAGCAGCGTCACGATGAACA	Mycobacterium insubricum
ACGGATTGCTTGACCACACCAAGCGCCACGA	Mycobacterium insubricum
TGGAACGCCGAGGACTGTGGCCAGGACTGCC	Mycobacterium insubricum
GCGTTCTCCACCACCTGTACCCACTGCGCGG	Mycobacterium insubricum
AGATGCCCTCCGGTTCGCCGTCGACGATGCG	Mycobacterium insubricum
GTCGAAATCCGGGACAACTCCAGCAACGGCA	Mycobacterium insubricum
AGGCCGTCCCGGTCCGCTACGGCGCCGACGT	Mycobacterium insubricum
GGCCGAGCCCGGATCGGTCGAGACGTTCCGC	Mycobacterium insubricum
GCCGCAGCGTTCGCAGAATGGGCTGGCTTTT	Mycobacterium insubricum
GATCCATGGTGTTGCCGTCGAGGGATCCCAC	Mycobacterium insubricum
TGCCCACCTGCAGCGTCAGGCTGCGCAGCAC	Mycobacterium insubricum
CCTACCCTGAGGCCACAGGAATGGGGGACCT	Mycobacterium insubricum
TCACCCAGCTCTACGGCCAGGGCGAGGCACC	Mycobacterium insubricum
CCGCGACGAGATCGCCCGCTACAGCCGGCAC	Mycobacterium insubricum
CGACCAGCACGGAATTCAGTACGGTCCGGCG	Mycobacterium intermedium
GATAGACATCTATTACGAGGACCTCGGCGAC	Mycobacterium intermedium
GATGCGCGGGGCCACCCTGCTGGCGCACAAC	Mycobacterium intermedium
GCGATTGAGGAACCAGATATGGGTGGACAAA	Mycobacterium intermedium
CGTCCACCTTGGCGCGGAGCACGGGTTCCAT	Mycobacterium intermedium
GACGGACAGCGCTTCGTTGCTCAGATAGCCC	Mycobacterium intermedium
TGCGTGAACAGCTGTGCGACATCGGTGCGGC	Mycobacterium intermedium
GTCCTTTCAAGTTTTCGGGGCAGGTCACCGA	Mycobacterium intermedium
GGTTCGGGATCGAGCCGGCGCGCTCAGTCCT	Mycobacterium intermedium
CGGCGTAGGCTCGCCAGACTCCGGACCGCAG	Mycobacterium intermedium
GGGATGTTCCCGGCGGGGACGGGGTCGCCGA	Mycobacterium intermedium
CACCAAGCCGCGGTGTCGGTGAGTTGGCGCA	Mycobacterium intermedium
GTCCACCTTGCTGTGCGAACACGTGACGGTG	Mycobacterium intermedium
GCAGTTTCAATTCCGGTTTCGTCAATACTGG	Mycobacterium intermedium
ACTTGGACGACGTCGATGCTGCCTTTGCGGA	Mycobacterium intermedium
TTCGCGGGGATCACCGCGCGTTACCTGGCGC	Mycobacterium intermedium
GGAGCCTGAGCCAGATACTCGCTTGGCAGGC	Mycobacterium intermedium
ACGTCTGGACCCGAGATGACGAGTACGACGC	Mycobacterium intermedium
TTCGCTCCCGAGTACCGGTAGGCAACATCTG	Mycobacterium intermedium
TTGACTTCTGACTTCGCGTGGCGCCGTCGGC	Mycobacterium intermedium
CAACTTCCGGTCTCGATCATCAGCGAGATCC	Mycobacterium intracellulare
ATTCCTACTAATTGGAATTCCATCTGCCTCG	Mycobacterium intracellulare
TCGATGTCGCCGGGGAGGTGACGACCTTCGG	Mycobacterium intracellulare
GACGCGGACCTCACGCCGGCCGACCGCAGGA	Mycobacterium intracellulare
CGGCGAGGTATTCGGCCGCGGTGTTGCGCTC	Mycobacterium intracellulare
GCGGGGACGTTGGCCGCCGGGATCGTTGGCG	Mycobacterium intracellulare
ACGCCCCGGGTGCGATCCTGTGACCCTGGCC	Mycobacterium intracellulare
GAGCAGGCCCGCAACCCAGACCCACCACGTG	Mycobacterium intracellulare
CACAGCGTCGTAATCGAACAGGACCCATTCG	Mycobacterium intracellulare
GCCGTGAAAGATCCCGGCGAACACGCCGGTC	Mycobacterium intracellulare
GCCCACGCCGCGACCGCCGGAGACCACGATG	Mycobacterium intracellulare
TGCCGGCGTTGATGAGATCGGGGTCCACGCT	Mycobacterium intracellulare
GACATCGGAACCGGCGAGATCCGTTTGGTTG	Mycobacterium intracellulare
GCTGGTCAACGACGCCACCCTGGGCAGCCTG	Mycobacterium intracellulare
CGCCATCGCCTCCGGATAGGGGGCCGAGCTG	Mycobacterium intracellulare
CGTGGCGGGCACGGCTTTCACTTTAGGCACC	Mycobacterium intracellulare
CGCGGTCGACGTGGACGGCGGTCTGGCCGGG	Mycobacterium intracellulare
ACGGCAGCGCCGGTGAAATGACTCCGTAACC	Mycobacterium intracellulare
CAGCTGACGGTAGGACTCGTCGCGCCCGCTC	Mycobacterium intracellulare
TGACGGGCAGACGTTCCACCTCACCGCCGAG	Mycobacterium intracellulare
ACGGTGCTCGCTGTGGTCGAAAGGGACGGCC	Mycobacterium iranicum
GGCGCTCGGCGCGGGCGCGATGGGCCGAATC	Mycobacterium iranicum
TGAACAGACTAACGCATCCACGACACGATCA	Mycobacterium iranicum
CACTCGACGATTCGGGACGAGTTGGTGGCCG	Mycobacterium iranicum
TGAGCCGTATCGCCGAACGAGGAGTTCGGCT	Mycobacterium iranicum
AGGCGTTGATGAGGTGCACCGCGTTGTCGCG	Mycobacterium iranicum
AACGCGCCGGTCAAGATGTCCGACGGCACCC	Mycobacterium iranicum
GGCGGCGTCACCCACCTCGTCCCGCGCGACA	Mycobacterium iranicum
ACCTCGGTCCCCGTCACCACGATTCCCGCGC	Mycobacterium iranicum
CATCACCGCCATTGCCGCCCGCACCGCCGCC	Mycobacterium iranicum
CGGTTACACCTACATCACCCGCAAGAACCGG	Mycobacterium iranicum
GAACGCGGCGGCCAGGATGCCGCCGATCTGG	Mycobacterium iranicum
TGCCATACACGCTGCGCGGGATGGTGTGAGG	Mycobacterium iranicum
CGACGAAGGACGACACGAGTTCGTTTGCGGG	Mycobacterium iranicum
GGTCGCGTTGGTGGGCAGCTCTTCGCGGAAC	Mycobacterium iranicum
TCACGAACAGCAGAACCACTGCCTCGTCGCT	Mycobacterium iranicum
GGTCGCCGCCACGGCCGTCGCCGCCTTCGTC	Mycobacterium iranicum
TCCGTACCCAGGATGATGGGCACCACCGACC	Mycobacterium iranicum
GCCTCCACCCGGTCGCGCAGACCCACCAGGC	Mycobacterium iranicum
TTCGAATCGTGCGATGACAGGATGTGTACGT	Mycobacterium iranicum
GGGACGGCGGCTATGGACTGTCGCACCGTGT	Mycobacterium kansasii
CCGGGACCCGGCCTGCGCCGCTTGTTCGGAA	Mycobacterium kansasii
AGCACACTCGGCGCCGTCAGCGCACACTGGA	Mycobacterium kansasii
CGTTGTGACGGGCTGCCCGGAATTGCGATGG	Mycobacterium kansasii
GATAGACCCGCGTTGCTGGCGGCTCGCCCGC	Mycobacterium kansasii
CCACGCCGAAGCCGAAGCCGCGCCGAAGCCG	Mycobacterium kansasii
CGCTCGAGGGAGGTGTACTCCCGCGCGTGGA	Mycobacterium kansasii
ACCAACCGCTACGCACTGGCCGCGCAGATCC	Mycobacterium kansasii
GACCCGGGGGGTGGCTTCCTTCCTGGTGTTG	Mycobacterium kansasii
ACCGCAACAGCCCATCAATGACATTCAGGCC	Mycobacterium kansasii
TCTTCGATATCGGCCGCCATCGCCACAGCAT	Mycobacterium kansasii
GTGGTCGATACCGTCCAGGGTACGCGCGTAG	Mycobacterium kansasii
ATATGGACGACCAGTCCCCGGTGGGAAGCGA	Mycobacterium kansasii
GGTCGTCAACGTGCTGACCGACCCAACTGTC	Mycobacterium kansasii
AAACAGCACTTGGGTGCCCGCGGGCAGGCTC	Mycobacterium kansasii
CGGGGTATGGCCCATGCTCGGCGTCCTCGCA	Mycobacterium kansasii
TCCTGCTGTGGCCGAACGGGTTTCGCGACGG	Mycobacterium kansasii
CCAGGTGAGGTTCGGCCAGGTCGCCGCAGAC	Mycobacterium kansasii
CAGTTCCTTCTATCCCATGACGATCGCGTCG	Mycobacterium kansasii
GGTTCGCGCGTTCGTCGAGCGCGGCATCACC	Mycobacterium kansasii
CGAACGCGGCGCGCCGCACCAGCAGACACGC	Mycobacterium koreense
CGGCGGAGTCGCTGTGCGACACCCAGACCGA	Mycobacterium koreense
GACTACACGTTCTCCTAACGGGCGCCGAAGC	Mycobacterium koreense
TGGCCGCGGCGCTGGGCCGGGCCCAGCCGGC	Mycobacterium koreense
ACCGGGGCCAGCGGGCCGGCGCCGACGGGTG	Mycobacterium koreense
CCGGGAACCGCACCGTCCAGAACCGGACGAA	Mycobacterium koreense
CACCGTCGGTGCCGAACAGTCGACCCATGGC	Mycobacterium koreense
ATTGCCACCGCCGTCAACGCCGAGGGCCACC	Mycobacterium koreense
CTGCCGTTGAACACCTCGGTGGAGCGCGGCG	Mycobacterium koreense
CACCAAGTTCGCCGACGACTGGCTGGCCTGT	Mycobacterium koreense
GCCCGCCGGCACCCAGCCCGACTACGGAGCC	Mycobacterium koreense
GCACCCATCACCCGATAGGTGGTGTACTTGC	Mycobacterium koreense
CGTCGTCCTCAGTTTCGGTATGGCCCTGACC	Mycobacterium koreense
CGGCGGCGCGGATTCGCGCCTGTGAAGCCGA	Mycobacterium koreense
CAGCTCGGCCATGGCCGCCGGGTCGGCGGCG	Mycobacterium koreense
CGCGGTGCCGATCACCGCCGTGGCCAGGGTC	Mycobacterium koreense
CCCGCGGCCAGCACCCTGGCACTGGCCGACA	Mycobacterium koreense
CGCCGGTGAGATCCTGGATGGTCTCCACGAC	Mycobacterium koreense
AAGGCCGGACCCGGTGAGGTCGTCGACGCCG	Mycobacterium koreense
ACCGTGGTCGTCCCCGACGCCGACGGACTCG	Mycobacterium koreense
CGCGCCGACGTCCAACAGCTCGACCCGGCCG	Mycobacterium kubicae
CTGAAAGAGCGCCAAACCAAACACCACGCCC	Mycobacterium kubicae
CGGCACCAGGTAGCGAGCCGCGTAATCGCGC	Mycobacterium kubicae
ACCAAGACCACCCTGGATGTGGACGGCCATG	Mycobacterium kubicae
CCGAAGGCGTCGAAATGACGGGCTCGTTCAG	Mycobacterium kubicae
CCGCTCGGTCTCGGACACCACGTTGGCCGGG	Mycobacterium kubicae
GACCGCGAGTTCGATTACCTGGTGTCCGCCG	Mycobacterium kubicae
CATCCAATTCGATAGTGGCTCAGTTGAACCG	Mycobacterium kubicae
GCTCGGTCGTCGAAGAGGCCACCCTGGCGCG	Mycobacterium kubicae
CCAGCAGGCGGCCTACCGAGCCATCGAGAAG	Mycobacterium kubicae
CCAAGCGCGGCAAACTCGGGATCCGTTGGTA	Mycobacterium kubicae
CGTCACGCAAAGGGTTCGATTTGCGCGGTTT	Mycobacterium kubicae
GGCGTCACTGCTGATCGGACAGGTTCCGACC	Mycobacterium kubicae
CACTAGCCGGCCAACGCGGCCCGGTCACCGG	Mycobacterium kubicae
GCCCGCACCCTAGAAGTGCTCGAAGACCTCG	Mycobacterium kubicae
GGCGTAGCGGGTCCGGGGTAGCTGCGCCACG	Mycobacterium kubicae
AGCCCGCACGGTGTGGCTGTCGGTGCGCACC	Mycobacterium kubicae
CACCGCGGCCGTCATTCTGAAACGCTAAGGC	Mycobacterium kubicae
GACCCACACGGTGCACCACACCGATCGCATC	Mycobacterium kubicae
GGTGACGACGGGGGTTGCTGCCGCGGCGGCT	Mycobacterium kubicae
TGGACTGGGCGGCCTGCGAAGTCGTGCCGGA	Mycobacterium kumamotonense
GTCGTGCAGCTCCGATTCGGGGGGCATCACC	Mycobacterium kumamotonense
ACCAGGTCGTGGTCCGACGCGGTCATCGCCC	Mycobacterium kumamotonense
GGTCGAGTACCCGGCCCCGGCCGGCCAGCCC	Mycobacterium kumamotonense
AGCCGGTGACGAAACCGGCCGGCTGCCCGTC	Mycobacterium kumamotonense
GTCGGCTTACTGTTCGGCACGCTCGCGGGCC	Mycobacterium kumamotonense
GCGACGGAGAGCTGTCTCCGGCGCAGCTGAC	Mycobacterium kumamotonense
TGAGGCGGGTGGACTCGCGTGCTTCCTGGCT	Mycobacterium kumamotonense
CTCCGGTTTCTGCGAGCCGCCCCGGCCGGCC	Mycobacterium kumamotonense
CGCAGTGCCCGATTCAGGACGACGTCGGCGA	Mycobacterium kumamotonense
ACGGAACGAGTGCCCGTCGGCCGGTGCGTGA	Mycobacterium kumamotonense
CGGTCACCGGCGCCATCACCTATGCCCGCTC	Mycobacterium kumamotonense
GCCTCGGTGCAGCCGTTCACCCAGGCCGCCC	Mycobacterium kumamotonense
GCCGGACAGTTCCGGGAACGCCGTGGCCACC	Mycobacterium kumamotonense
CGGCGTCAACAAGGCGATCGACCTCATGGTC	Mycobacterium kumamotonense
ATCTGGCCGCGATGGGCATCGCCAACCAGCG	Mycobacterium kumamotonense
GTCGGTGGCCGATGGTAGACCTGTCGGCATG	Mycobacterium kumamotonense
GGGGTCTTCGCCCGCGCCGCGGGCCTCGTGG	Mycobacterium kumamotonense
GCGGTCAGCGGCTGGGTCTTCGGCGATCGGG	Mycobacterium kumamotonense
GCTGTCGAGCACCGGCGCCTACCCCAAGCGG	Mycobacterium kumamotonense
CTGATATCGCTAACTCGGTCACCCAACAGCC	Mycobacterium kyorinense
CGCGGACCCCAATGTCCCATTCGCCAACAAG	Mycobacterium kyorinense
CGCACCGGTGAGCCAGCGCGGCAGCCCGGGG	Mycobacterium kyorinense
CGCGGTGGCGCCGTCGGGATCGGTGTAGCCC	Mycobacterium kyorinense
CCGGCTGCGCAGTGATCGCGTGGTACACGCT	Mycobacterium kyorinense
GTGCCCCCCGCCGGTATAGCCTTTGAAGCTC	Mycobacterium kyorinense
CCTGCCCTGGTTGCACCACGGTGACGTGGCG	Mycobacterium kyorinense
CGTCATCGACCCGCAGTACGTCCAGCGTCGC	Mycobacterium kyorinense
GCAGGCCACCGAACAGGAATCGGCGCGTTGG	Mycobacterium kyorinense
GCCGCGGCGCGTTCGGGCTGCCCGGGTGGCC	Mycobacterium kyorinense
ATCACGGCGCCGACGTCGAAGAACTCGAGCT	Mycobacterium kyorinense
ATCACCCGCTTACGCAGGCCCTCGGTCGCGG	Mycobacterium kyorinense
GCAAGAGCGCCTCCCTATAGGAGGCCTGGCA	Mycobacterium kyorinense
CTGGCCAAATTTGGTGCCGGCAGCAGGGTTT	Mycobacterium kyorinense
CAGCGCCTGCACCAACAGCACCGAACCCAGA	Mycobacterium kyorinense
TGTTCCAGCTGGTGTCGGCCGGCGGCATCTA	Mycobacterium kyorinense
CCGCTTGAGCCACTCGCCAATGACGATGGTC	Mycobacterium kyorinense
TGCGAACAAGGTGTCCAAGATGTCGTCGATG	Mycobacterium kyorinense
CCGTCGTCTCCCCCAGCGCCTCGGCCGGTGC	Mycobacterium kyorinense
GTAGGAGAGCAGTTCGATGATGTCGGGCGTG	Mycobacterium kyorinense
TTCTGCTCGCGGTCGGCGGGCACGTCCACCC	Mycobacterium lacus
TGTCCGCGACACCCGAGCCAGCGGTTAAACC	Mycobacterium lacus
TTGGGATGTTCGGCGGCTGTGGGGCCAAATC	Mycobacterium lacus
CCAGCGCCGCGGCGCGCTCCCCCTCCGATTC	Mycobacterium lacus
TGTCGTCGAACACCAACGGCGAGGGTGATAT	Mycobacterium lacus
ATCACCACGGTGCGCGGTTTAGCGGAGCGCA	Mycobacterium lacus
GCGACCTGCCGGCCCAAGACCCCGAATTCCG	Mycobacterium lacus
CTTGTCTTCGTCGACGATGGCGCCGTCACCG	Mycobacterium lacus
AATCCCGGCTGCGCCTTTGATTCGGGACTGG	Mycobacterium lacus
GATGACTCGCATGCGCTGACGGTGTCGGACG	Mycobacterium lacus
TCGCGATCACCACGGGCGTCGATGGTGGTGA	Mycobacterium lacus
CCGACTTCATCGAAATACGCCGGGCCGCTGG	Mycobacterium lacus
GGCGTGGGTGAACTGCTCGGCGAGCCGGTGC	Mycobacterium lacus
TTCAAGCTCAAATCAGACGGCCACGCGGCTA	Mycobacterium lacus
AAGAATCTGAGCCGCACCCCGACGGCGCTTC	Mycobacterium lacus
ATGCGTCGCAACGATCCGCTGTGAGAACAGT	Mycobacterium lacus
GCGCCGTAGGCGCCGCGGCACGATTGGCCAA	Mycobacterium lacus
CTTGACCCTGGCATCACCGCCATGCTAAGCA	Mycobacterium lacus
CCCGACGTGGTCCGTGCGTTCACCGAACGCG	Mycobacterium lacus
TCACCGCCGAACAGAAGCACAGCATCGACGA	Mycobacterium lacus
CCAACCGAACCAGCGGCCGGGCGGTCACGGG	Mycobacterium lehmannii
ATCGGTGTTGACCTGACCGGAGTTGTCCGTC	Mycobacterium lehmannii
ACCCGTTCGGCGCCGCCCATGTCGTAGGCGG	Mycobacterium lehmannii
CCGAACCGCTGGGTCAGGCTGACCTCGTCGG	Mycobacterium lehmannii
TTTTTGCGCGGTATCCCTGGACCAGTTCGGC	Mycobacterium lehmannii
CGGGCTTCGATGCCAGCGGCGTCTTCCGTGA	Mycobacterium lehmannii
TCGGCGTGAACCCCTGCGCAGTCAGGTCGTC	Mycobacterium lehmannii
GCACTTGCCAACGGCATCCCGGTCATCGAGG	Mycobacterium lehmannii
GACGACGTCGGAGGCGCGGTTGGACAACAGG	Mycobacterium lehmannii
ATCGCGCTGGTCCAGCCCCAGCTTCCGCCCT	Mycobacterium lehmannii
CCACTCTCGGATCCCTGGTCGGGGCGGCGAT	Mycobacterium lehmannii
GGGCTTCCTCGCGCCGGCCGTCAGGCCGCCT	Mycobacterium lehmannii
GCCTTCTCCAGCGTCTGCATATCGGCGAGGA	Mycobacterium lehmannii
GCGGGGTCTTGAACAGACCCGGGGCGATCGT	Mycobacterium lehmannii
GGCGCAGCGTGGGGTCGAGGCGCTCGACGAT	Mycobacterium lehmannii
ACCGGTCCTGCGTCATCACGACACCGGTGAA	Mycobacterium lehmannii
GTCCCCTCGGCGACGGGTCATGCCGCCAGTG	Mycobacterium lehmannii
GTAGGTGTCGTTGGTCATCCGTGCTCGAGCT	Mycobacterium lehmannii
CGCGACGCACACCGAAAGCGGTGTTGATGCT	Mycobacterium lehmannii
ACCGGCCTGTAGGAGCCGGTCGATCACGTCG	Mycobacterium lehmannii
GCGTAGATGCGGGTGGGCTCCAATAGCTCTT	Mycobacterium leprae
CTAACTATCGATGAGCGCGCCCATGGTCGGC	Mycobacterium leprae
CCGCGGTGAGGTACCCAGTTCGAAGATCGTA	Mycobacterium leprae
GTACCGACCACGGCATCGAGGTTCCTGGGCA	Mycobacterium leprae
TCCTGCACGTCGACAGCCTGTTCGAAACCAA	Mycobacterium leprae
AATGCAGGCGACCGCCACCGGCAGCAACCGG	Mycobacterium leprae
GTTCCGTTGCAGGGGCCGTCGGCAACACCCG	Mycobacterium leprae
TCCCGTGGGTGGTCGGCTTCAAGCTGAGTGG	Mycobacterium leprae
GCGCGGCCAACGTGTCGACAACTGTTTGCAG	Mycobacterium leprae
ACCCTGCGTGGTATCCAAACCGGGAAGGCCA	Mycobacterium leprae
GTCCTTATCTGAATATCCGAAATAGAACTCT	Mycobacterium leprae
TTCGATAGGCGGGGTAGTGGTGGTTTTGGCT	Mycobacterium leprae
GCCCTGGCAGGCGGTGTCGTGGGTGGGCTAT	Mycobacterium leprae
AACAGACGCCAATCACACGGACAGTCAGTTA	Mycobacterium leprae
TCGCTCTCGCTGATGCCGAGTTGGCAATGTG	Mycobacterium leprae
CACTAGCGGTCAGTTTTGTGAACAGAATTCT	Mycobacterium leprae
CCGTGACATTCTGATCTCCTGTGTGGCCGGT	Mycobacterium leprae
CCGCGGTAGCCCGGTTTTGGGGTGGCCGACT	Mycobacterium leprae
TAGGCGCCGACAAGCTCCCGATAATGGACAC	Mycobacterium leprae
CGCGCTGGTTGTGTCTATCCTGTTGACCCCA	Mycobacterium leprae
GTCGGTTCTGGTACTGTGCCAGCCGATGCTG	Mycobacterium lepromatosis
GCTCACTACCCGCGTTTTCACGCAGCAATCC	Mycobacterium lepromatosis
CGCTGGTGCGGGTGTTCGACGACTATGCCCA	Mycobacterium lepromatosis
GAAGCTAAAACCGGCCAGTAAGCGGCTCCAA	Mycobacterium lepromatosis
GACTTCCCGGATTCGCATGCCCTCTGGGCTG	Mycobacterium lepromatosis
GCCAGCAGTCCAGAATCCCGGTGGTGTGGCG	Mycobacterium lepromatosis
TGCGGCATGACTCGAGACGGGCATTTACGTC	Mycobacterium lepromatosis
TGATGCTGTCACCCATTAGGTATCGCTGGTT	Mycobacterium lepromatosis
TGGGGCTGGTGTCATATCGGGTGTCGGACGA	Mycobacterium lepromatosis
GTTCTCGAAACCCGGTGCGCCCGTCGTTGGG	Mycobacterium lepromatosis
GGGGTTGACGTATGAACCGTATATGCGGTTG	Mycobacterium lepromatosis
GACCCTACACTGATCCTGACGCGGTGATCAA	Mycobacterium lepromatosis
AGTGAGATCGCGCTAGCCCAAGAGGTTTCTG	Mycobacterium lepromatosis
CCAAACTTGGTCGCAGCCGCCATGGCGGCCG	Mycobacterium lepromatosis
TGTGGTGTTCGAAGATATCAAGATTCAGCAG	Mycobacterium lepromatosis
ATACCGTGCCGGTGTTAGAGCTGCGGGTCAG	Mycobacterium lepromatosis
CACAAACCGTGGATGGAGGCGGAGGACTCAC	Mycobacterium lepromatosis
TGGAACGGTCGCTCTATCAGGGGCCGCCAAA	Mycobacterium lepromatosis
GAGTCCATCGAAAAAACCGGCGCCAACGTCT	Mycobacterium lepromatosis
GTCATCTCCGGGTGCCGGGACCAAACGACCC	Mycobacterium lepromatosis
TCTTCCTGGCGTTCGCGGTCTCCGAGATGAT	Mycobacterium litorale
AACCTCGATCAGCCCGGCCTGGTGCTGAGCG	Mycobacterium litorale
GGCATGCGTCGCATCGATGCCTACCATCCGT	Mycobacterium litorale
GACGGTGACGGCACGGTGCGCGACGGTGACC	Mycobacterium litorale
TTTCCCGCAGCCGCGTACGCCGCGTGAACGC	Mycobacterium litorale
CGGGGCGGCCGCGACGACGAGCCCGGCGCCG	Mycobacterium litorale
CACCGATGACGGTGAACTCCAGATGGTCGGC	Mycobacterium litorale
CCGGCGACTTCTACCGCCCGGTGCACCAGAA	Mycobacterium litorale
CGGGGCTCCTGACGAGCGCCGATCTGCCGCT	Mycobacterium litorale
GGTTTCGCCGGCGGGCGGCCGCGGCCGGTGC	Mycobacterium litorale
TGCGCTCTTGGTGGCGGTGGTGCGACCGCAT	Mycobacterium litorale
CCACGCCTATCGGGCCACCTCCTCGGATCAG	Mycobacterium litorale
GCGGTCGGGCGTAGCAGCAGCCTGAGCAGCC	Mycobacterium litorale
GCCTGCGGGTCCGGCCGCCCCGACGGTCAGC	Mycobacterium litorale
TGATCGCAGCGCCGAGGAAGGTCAGCCACAG	Mycobacterium litorale
GGCCGCCGCGGTAGCTGAGGTAGCGGGGTGG	Mycobacterium litorale
GGGCGCCGTTGATGGCGTTGCGGGCCTCCGG	Mycobacterium litorale
CCGAGGGCGGCGGCGAACTGCTGCTGGTGTG	Mycobacterium litorale
GCTGTCGTCGATCGCGGCGAGGTCCGAGGGC	Mycobacterium litorale
TATGCCCTCTCGGTCGGGCTGACGAACGGCG	Mycobacterium litorale
CTCCCGCACCAGTCTCCCGCTGGTCGAGGCT	Mycobacterium llatzerense
CAGAGGTCTCCGAGGCCATCGATTTCGCGAA	Mycobacterium llatzerense
GCCTTGAGCGGCAGGCGGTCGCCGAACTTCA	Mycobacterium llatzerense
GAACGCGGCCTGCCACTCACCGGACTTCTGC	Mycobacterium llatzerense
CGGGGAAGCGGTCGATGCAGTCCCGCAGCAC	Mycobacterium llatzerense
AACGTCGAGACCTCGCCATCGGCGGTGACCC	Mycobacterium llatzerense
CGACGATGGGGCCCAACGCGAGTGCCGGGAG	Mycobacterium llatzerense
TTCCGAAGCCGGCGTCAAGGGCACCTCCGGC	Mycobacterium llatzerense
GTGAGCGGCCAGGCGCAGCGCACAGTGGTGC	Mycobacterium llatzerense
TCTGACGTGGAGCTACGTGCCGTCCTACTTC	Mycobacterium llatzerense
ATCGCCAAGCGCGATGCGCAGCGGGAGATCA	Mycobacterium llatzerense
GACGCTGCCGCCGCATCTGCGTGCCGCGCAT	Mycobacterium llatzerense
GGCCAGTTCGCCGAGCTGGCGCTGCAACAGC	Mycobacterium llatzerense
ACCGCGGGGTGTCTCCGCTTACCGGCCCCCA	Mycobacterium llatzerense
GCACCGCGCGGGTCGGTCTACCACCACTTTC	Mycobacterium llatzerense
ATCACCCGCACCGGACGACCACGGCTGCACA	Mycobacterium llatzerense
GTCAGGGTTGCGGGTGGTGGCGAGCACCGTC	Mycobacterium llatzerense
CGTCCAGACCAGGGCGTCGACATAGCGCAGC	Mycobacterium llatzerense
GCGGCCGGGTTCTTTTGGCAGTGCTAGCGGT	Mycobacterium llatzerense
GTGGAGCTTCCGCCGGCAGGGCATGTGGAGC	Mycobacterium llatzerense
GACGATTCCACGCCGCCGTTTGCGTTCGTCC	Mycobacterium mageritense
TCGACGGCACGATGCCGACCTGCGACGGCGC	Mycobacterium mageritense
TCTCGGAGGCGAGCCAGCAGGGCCCGGCGTG	Mycobacterium mageritense
ATTCGCGGGCGAAAAACTCGGTGTCGCGCAC	Mycobacterium mageritense
GTGATGGCCGCGTACAAGTCCGCTCTCGAAG	Mycobacterium mageritense
GTCGCCAATCCCCCGAGTTTTTCGTTGACGG	Mycobacterium mageritense
TGCTCGACGCGGCCTCCGGCAACGTCGAAGG	Mycobacterium mageritense
TGTGCCCGCACTACAGCCGCAGCCGATTCTG	Mycobacterium mageritense
GACCGCCATCGCTCGGTGTTGACGGCGCTGG	Mycobacterium mageritense
GGCCGAAGAGGTCAAGCTGCGGCACCGTCGC	Mycobacterium mageritense
GGCCGCGCTGCTGTGTGAGATCGATCCGGTG	Mycobacterium mageritense
CTCAGTCCTTTTCGGAGGCGTGCTGGGCATC	Mycobacterium mageritense
AGCACCGCCTCGCTGATCGGGTCGATCCAGT	Mycobacterium mageritense
CAGGTCCATTGCCAGCAAAGTGACGGTGGGC	Mycobacterium mageritense
CCTAGACCCAGTACGGCACGCGGGCCCGGTA	Mycobacterium mageritense
CGCCATGTGCTTGCCGACGCCGACGAACTCG	Mycobacterium mageritense
CGGCGGCGGTGGGCCGCCCGAAGTGTCCGGC	Mycobacterium mageritense
GGCATGGCCCGGGTAACCCGACTTGGGTGAC	Mycobacterium mageritense
TGCAGCACGGGCGTCGTGGCCTGCCACGTGC	Mycobacterium mageritense
GGCGCGCACGTCGACCCGGCATGCCCGGATC	Mycobacterium mageritense
GGCTTTGCTGAACTTGCGGTCGCGCTTTTTA	Mycobacterium malmoense_B
TCGTGGTGACCCGCAAGTCCGGCTCGTCGTC	Mycobacterium malmoense_B
GTATAGGGCTCCGATGCCAGGGGAAGCAGCA	Mycobacterium malmoense_B
TGGGGAGGGTCATCGGTGCGGTCCTTCGGCT	Mycobacterium malmoense_B
GCCGATCGTCAGCGGCAAATCGAACAGGATT	Mycobacterium malmoense_B
AATGCGTAAGCAAAGTTCGGCGCCGCGGTCA	Mycobacterium malmoense_B
GCTCACTGGGTCGGCGGCCCTGCTCGCGTTG	Mycobacterium malmoense_B
GTCCAGCGAGATCTGCAACGGCCTGCTGCGC	Mycobacterium malmoense_B
GGTTCGGATAGCGCTGTCCGACAAGGGAATT	Mycobacterium malmoense_B
CAGCGTCAAGGTGGCGATCCAGTTCTTGAGC	Mycobacterium malmoense_B
TTGACCGACGTGGCGCACGCCATCGAAATGG	Mycobacterium malmoense_B
CGTCGTCGCCGGGGCTGGCGGCCATCCTGCC	Mycobacterium malmoense_B
TTGGCGAATTCCTTTGTCATGGAGGACATCA	Mycobacterium malmoense_B
ACCCCGACCAGCCGTCCCGGCAGCTGACGGG	Mycobacterium malmoense_B
GGCCAGCGCACCACCGCGGTCCCGACTTTGC	Mycobacterium malmoense_B
GCGGCCGCGCCACTCGTCGGCGTCGGCCTGA	Mycobacterium malmoense_B
GCGCGTGATCCAGGTCTTCCTCTATGTAGAT	Mycobacterium malmoense_B
ACCGTCGGCGGCCTCGGCGACGACCCGGATG	Mycobacterium malmoense_B
TCACCGGTGGGTGGAGTTTAGTTGCGCTTCA	Mycobacterium malmoense_B
GTCGAGGATGAGCCGACACCCGAGGCGGATC	Mycobacterium malmoense_B
TCAAGGCGAAACGGCGGCTGCAGAAGATGGA	Mycobacterium mantenii
TCCGCCGATTTTCGGCATTGAGCTGTTGAAC	Mycobacterium mantenii
CTCGCCCAGTTGCGACCACAACTGTTCGGAC	Mycobacterium mantenii
ACCGGACAATTCGTGGGGCAACCGATTGGCT	Mycobacterium mantenii
CATCGCCGTCCAGATCGTCGGCAGTTTCGCC	Mycobacterium mantenii
TCCCCAAGGCTTCCGAGCCCGGCGCCCTGCA	Mycobacterium mantenii
CGGGCGCCGCGACCCGGCACTCGATGAACTG	Mycobacterium mantenii
CGTCTTTGATCAGGGGCAGCGTCTGCTTGAA	Mycobacterium mantenii
GGCGAGCGACAACGGGTGGTCATCGCGATCG	Mycobacterium mantenii
AACTGGACGCATCGCTGCACGTAGAAAGCAC	Mycobacterium mantenii
GACGCCCTTGCCTTCGTGCGCGATCTTGTAT	Mycobacterium mantenii
GAGGCCGGCGACCCGGCCGGGATCGGGGGAG	Mycobacterium mantenii
GGCCTGCGCGGCCGTGGTGGTCATCCAGGTG	Mycobacterium mantenii
GACGTCGCGGCCGCCGTCCGCACGGGGACGT	Mycobacterium mantenii
ATCGGCGAGTTCGGCATCGACGCCGAATCGG	Mycobacterium mantenii
GGCACCGCTGATGAAAGCTACCTTGCCCTCG	Mycobacterium mantenii
GCTGCTCGCCCACCAGCATCAGCGGCGCGCC	Mycobacterium mantenii
GATCGCGCAGCCACTGCACGGCCGCACCGGT	Mycobacterium mantenii
AGCCGGTCGACCGGAAGGCCCCAGCGGGTGT	Mycobacterium mantenii
GTCGCCCATGCGGACCAGCGCGGCGCGGACG	Mycobacterium mantenii
CAGTATGCCCTTCGGCGCACACGCAACCGGG	Mycobacterium marinum
GCATATGAGCAAACTGAGGTTTAGCTGAGAA	Mycobacterium marinum
CCGGAAGGCATCACGGACCAGCTTTTTCTCA	Mycobacterium marinum
ACTACGAAGTGAAGTTCAGCGATGAGTCCAA	Mycobacterium marinum
CTGGGGCCGGGAGGCTGGATACGGCAGCAGC	Mycobacterium marinum
TTGGACACGCAAGCGAGCCTAGTGAGACAGG	Mycobacterium marinum
AGCCGCGGGAACGCAAACGAATGAGCTGGCA	Mycobacterium marinum
TGATGCCGTTGATGGCCTCGAAGACGGCGAG	Mycobacterium marinum
ACGTGCGTGGCGACGTGGACTGGGAGGCGCT	Mycobacterium marinum
ATCTGGCTAGGCTGATGACCCCGTTCGCCGA	Mycobacterium marinum
CACTGGATGTCCTGGTGAACAACGCCGGTTT	Mycobacterium marinum
CTGCCGACGCCGAGGCCACCGACGCCGAGGC	Mycobacterium marinum
CCCATCTGCTTGAAGGTGGAGCCGACCTGAG	Mycobacterium marinum
GCCACGGTCGTGCGCAGGGGGAGGTTGCGTC	Mycobacterium marinum
GGCCAGATACAACGGTGGGTGTCACTGCTGT	Mycobacterium marinum
GGCGCCGATCGTCGCCGGTGTCGGTGCTTGG	Mycobacterium marinum
GAAGTCGGCTTCGAGGTGCTGCACGAGGAGA	Mycobacterium marinum
GATGATGGTGCGCAGGGCGGCGATCTGCTCG	Mycobacterium marinum
CGGAACCGGGAAGCTCGACCAAGCGCGACCC	Mycobacterium marinum
TTGGTTCCTGTTGACCGGGCAGACCGTGCTG	Mycobacterium marinum
GTCAGCAGCACGATCCGGCCGGGCGGGGCCA	Mycobacterium marseillense
CGATCAACAAGCCGCCCAACAGGCTGAGGTC	Mycobacterium marseillense
CAAATACTCAGGGACGTAGTGGTATTCGCCC	Mycobacterium marseillense
GCCAGCACGTCGTCGAGCCGATCGCGACGGG	Mycobacterium marseillense
CTATCTCGCCACCGATGGTGACCGCGAGGGC	Mycobacterium marseillense
GCACGATCGAGGGGACCGTCGCCAGCATCGT	Mycobacterium marseillense
TCCTGCGCGACCTTGTTCTGGGCCTGCTGAT	Mycobacterium marseillense
AGGGCGGATCGGACGGGTTGTCCAGGATCTC	Mycobacterium marseillense
GGCGGGGCGTAACGGGGTTGGACGTCGAATG	Mycobacterium marseillense
ACCGCCGCAATGCGCACCTGAGCCTGGTCGC	Mycobacterium marseillense
CCAGTCCGTCAGCCACGTGCCCAAGTCGACG	Mycobacterium marseillense
CTATCGCGGGTCCACGCTCGAGGCCCTGATG	Mycobacterium marseillense
ATCAGTTCGGTGTGCGAGGCCAGGTAGTCCT	Mycobacterium marseillense
TGCGGTCCGCTACCTGCACCTCGACGTGACC	Mycobacterium marseillense
TCGAGGGCATACATTCGCGCGTGTTCGTGCC	Mycobacterium marseillense
TTTCGCTGAGGCGATCAGTCTACCGCGAACC	Mycobacterium marseillense
TGCGCGGCCTGCGACGCCGGCGCGTCGATCT	Mycobacterium marseillense
CTGACCGGCAACGACTGGCTCGCGCTGCTGG	Mycobacterium marseillense
GTTGGACAAGGCCGACGCCCTGCGCTACATC	Mycobacterium marseillense
CTTCGCCCGGCGCCGCTCGGTCTCGTCGATC	Mycobacterium marseillense
GTGCACATCATCGGCCTGCCCAGCGGCGCCA	Mycobacterium minnesotense
GGCCAGGCGGCCACCGACTCTCTGTCGGCTC	Mycobacterium minnesotense
CGAGAACCCGCACCAACTGCGGGGCATCACC	Mycobacterium minnesotense
GACGATGGCCGGTGACCCGGGCCGGGCACTG	Mycobacterium minnesotense
GGCGATCATTCGGGTCAACCTGGCCGGCGAC	Mycobacterium minnesotense
GAACATCACCTCGATACCGCCGGTGAGATCT	Mycobacterium minnesotense
GGCCTCAAGGGTGTCGGCGGTCTCGCCGGAC	Mycobacterium minnesotense
GGATCATCGCCGGATACGTGATCGCCTACCT	Mycobacterium minnesotense
GTTTCGATCCCGGTGACGGCCTGCAGAACCC	Mycobacterium minnesotense
TGCCCGGAGCCTCGGGCGAAAACCACCTCGG	Mycobacterium minnesotense
ACCGTGGCGCTGGCGACCAAGCTGTCGGCGG	Mycobacterium minnesotense
GTGTGTGCACGGGCGACACTGCACGCACCGG	Mycobacterium minnesotense
CCACATTCTGGTCGAGCAGCACCTGCTCGCC	Mycobacterium minnesotense
GCAGGTGCGTTCGGACGGCAGTGGTCTGCTG	Mycobacterium minnesotense
GAGGCGGGGATGTCCTTGGCGTAGTCGGGCT	Mycobacterium minnesotense
TCGTCGCCGTCGGGCAGGTCCAACCGGGGGA	Mycobacterium minnesotense
CGCTGCGCGTCAGAAAGCTGACTCTCCAGTG	Mycobacterium minnesotense
TCCGTTCGTCTTCGCCACCGAGCCCGGGTTG	Mycobacterium minnesotense
ACCTCGTCGAAACCGACCGTCACCAACGGGG	Mycobacterium minnesotense
GATCACCCCGTCCCGGATCAGCGCCCGTGGA	Mycobacterium minnesotense
TCGAGCAGCACCCCCGCCGAGAACTCCGGTG	Mycobacterium monacense
TTCGGGGACCACAAACTCGTCGAAACGGTGG	Mycobacterium monacense
GTCCGACGGCATCGACCCCTCGGCGGCCCAC	Mycobacterium monacense
ACCTTCGCCCAGGAACGGCTGACCTCCATGG	Mycobacterium monacense
GACCAGCCGGTCCAGTGACAGTTCGCCGGAC	Mycobacterium monacense
GACGGGCGTGCTGCTGGTCAGCACGTCCTCG	Mycobacterium monacense
GACGGCAGCTGGAGCAAGACGGCGATGTCGT	Mycobacterium monacense
GCAAACCGTGCACCGGCTGTCACGACGGCCG	Mycobacterium monacense
GCACACCATGACCAAGACCGGCCGGGTGCGG	Mycobacterium monacense
GCGAACCCGTGGTGTACGCCGCCACCCTGGG	Mycobacterium monacense
GGATACTCGCCATCGCCCGGCAGTACCGGGC	Mycobacterium monacense
ACGTGCGCAGCGCCGTCGACTTACCCGAGCG	Mycobacterium monacense
CACGGCGCGGAAGGGTTCGCCCGCGTCATCG	Mycobacterium monacense
GAAGCTCAGATCGTAGGGGCGCAAGGCGTTC	Mycobacterium monacense
GGCCGGTGAGTTGCACAGATGCGCGACCTCG	Mycobacterium monacense
TGTTCCTGCACACCCGCGGCCTCGCGGAGAA	Mycobacterium monacense
AGGTGAACACCTCGGCGAACGACAGGCTCGC	Mycobacterium monacense
AAACGTTGTCTATGACGCGCGCGGCGCGTCA	Mycobacterium monacense
CGGCAGCGGGGCCACGGCGCCGGCCGCGGCC	Mycobacterium monacense
CGATGACGCCACCGTGCACCAGCTGGTGTGC	Mycobacterium monacense
CACGACGGCCGAGAAGGTCTATCGCCACAGT	Mycobacterium moriokaense
GCGTCGATTCTGGCCACTCTCACCGTGATTC	Mycobacterium moriokaense
GCTGCATGACACGGTCGGGTCTGTTCCTGAG	Mycobacterium moriokaense
GCTTCGGAGAAATTGGTTCGCGGGTGATCAG	Mycobacterium moriokaense
ACACCCCGCAGAGCACCAGTAGCATCAACAT	Mycobacterium moriokaense
GAAGTGCTCACCGTAGGTGGCTTCCCAGAAC	Mycobacterium moriokaense
GAATCCCAGAAGGTCTCGTTCCTCGAAGCGT	Mycobacterium moriokaense
GGCCCCCTTCGTGCGGATCTGGTGTTGTCCG	Mycobacterium moriokaense
GCGACATCGACCGCCGACTTGGCCGCCTCGA	Mycobacterium moriokaense
AGATCCCGGAGCTGATGCAGTTCGCGTGCCT	Mycobacterium moriokaense
GGGTGTCGGTCAGCGGGCCGAAGTCCTTGCG	Mycobacterium moriokaense
CCGTCGGGTCGCTGTGGTTCAACTCGACGTG	Mycobacterium moriokaense
ACGCCGGTGATGAGCAACTGCGTGATACCTG	Mycobacterium moriokaense
GCTCGCAATGAGGAATTGCGGGCGATGGTGG	Mycobacterium moriokaense
AGACCTTCGCGCGGTTCCGGCTGGACGACGG	Mycobacterium moriokaense
TGACGTCCCATCCGGCTCTCGCCCTGTCACA	Mycobacterium moriokaense
GAACCGACCGCGATCGACTTCAGATCGCCCG	Mycobacterium moriokaense
AGCACCGTCTCGATCGCCGGGTGGTTGGCGA	Mycobacterium moriokaense
CTGCCCGGCAACGCGACCGTCAAGATCGGCC	Mycobacterium moriokaense
GTGCAGCATCACCCCGGCCAGCAGTGGTCCG	Mycobacterium moriokaense
GATCTGTTGGCACGCTCGTGGGGAACGGCCC	Mycobacterium mucogenicum_B
CGCTGTGCAGAAGCTCGGTGAGCCGGCGCCC	Mycobacterium mucogenicum_B
GAGGCGTCCGCGGAGCTGCTGGAACTCGCCG	Mycobacterium mucogenicum_B
CGCGCAGCTCAGCGGCCTGCCCTTCGGCCAG	Mycobacterium mucogenicum_B
GCAGGGCCTCGCCGACAACGGCGTGGTGGCC	Mycobacterium mucogenicum_B
AGCAGGCCCCAGGTTTCGCTCGGCACGTCGG	Mycobacterium mucogenicum_B
GCAGACCAAGGTCACGTTCAACACCGGTAAC	Mycobacterium mucogenicum_B
CCGAGCGCAAAACCTGGCCCGTTTCGCGGTC	Mycobacterium mucogenicum_B
CGAAGGTCCGGGTGGAGGCCTGATGAGCTGG	Mycobacterium mucogenicum_B
GGTGGTCAGGATCGGCAGGACAAAGGGCGTG	Mycobacterium mucogenicum_B
TGGCCACGGCAAGGCGACCGAGCTGCAGATA	Mycobacterium mucogenicum_B
ACGATGAGATGCGCGGCCGTACCCCGGTCCC	Mycobacterium mucogenicum_B
CTGCTGGTGCTCGCCGCCATCCAGTTGGTGA	Mycobacterium mucogenicum_B
TTTGGGCCTAGTGCTCAAGACGTCGGAACGT	Mycobacterium mucogenicum_B
ATCGTCACCGAGGAAATCGCCTACGAGAGCT	Mycobacterium mucogenicum_B
TCATGGTTCTTGGCTGCCGTGGTGGCCAGCG	Mycobacterium mucogenicum_B
CGCATTGCCAGTGCGGACCCGCTGACCTACC	Mycobacterium mucogenicum_B
ACTCGCCGTCCAGCTCCACCGCACCCGAATC	Mycobacterium mucogenicum_B
GGGTGTGGCGTGGATCTGTGTGGTGTCCGCG	Mycobacterium mucogenicum_B
GCGGCGGTGACGACCTCGTCGGCGGCGACGT	Mycobacterium mucogenicum_B
GTCGGAGCCTTCCGTGAGGATGTCCGACGCC	Mycobacterium nebraskense
GGCGACCTGTTCTTCGGTGAACCACTCGGCG	Mycobacterium nebraskense
GGCCGGCCAGGACGTCGAAGCTGGCGACGAC	Mycobacterium nebraskense
CTTGCCGATCGGTTCCGGCGTAGGTCTGCAC	Mycobacterium nebraskense
GCGTCACCCCAATTCACGCGCAGCCGGCTTA	Mycobacterium nebraskense
CCGACGCGCTGGACAATGTGCTCACCAACGC	Mycobacterium nebraskense
GCGCACGTGCTGATCGGTGCGCTCGATGAGG	Mycobacterium nebraskense
CCCGGTTGTCCGGCCGTCCCCAAGAACAGCG	Mycobacterium nebraskense
ACGCCGAGGGTCTCCCGGCGCGAATCCAGTG	Mycobacterium nebraskense
AACCTCCACCACGTCGGACGCCTGATCGACG	Mycobacterium nebraskense
TCGTGTTCACGCTTGGCGCGATCGTGGCCGC	Mycobacterium nebraskense
CGAGCTGCGCGCCGCGATCGCCGACATCCTC	Mycobacterium nebraskense
TGGTTCCCGAGTCGGTGGCCGGATCGCCGGA	Mycobacterium nebraskense
TGCCACGGTTGTCTTTTCCCACGACCGCAAC	Mycobacterium nebraskense
GCCTGGTATTCGTCTGCGAGGGCGCGCTGAA	Mycobacterium nebraskense
GAGTCTTGGTTGTCCAAGACAGTCGATGATG	Mycobacterium nebraskense
AACTCCTGCGCGGCGCGGTCACTGGGTGACA	Mycobacterium nebraskense
GAGCGGCCCGGACAGCGGCAGGATGAATAAC	Mycobacterium nebraskense
CGCTCACCGATCTGGTGCTGTCGCGGGCCGT	Mycobacterium nebraskense
CGCGGCGATCGGCACGTCGACCCGCCGGCGC	Mycobacterium nebraskense
CAGCGTGCGGTAGGGCTCCTCCATGGACACC	Mycobacterium neoaurum
GACCGCACCAGGTTGCCCAGAAGTCGACGAT	Mycobacterium neoaurum
CTCGTCCAGTATCCGATCACCGCATATCCAA	Mycobacterium neoaurum
CTGCAGCAGGAACCGCACCACATTGGGGTGC	Mycobacterium neoaurum
GTCCTGCTGTGCGTCGCGATCGTGGTCGCGG	Mycobacterium neoaurum
CGTGCTGGCCAATGTGGCCGGTTTCCACCAG	Mycobacterium neoaurum
GCCGGAGCGGTGCCCCGCACCGATCATGATC	Mycobacterium neoaurum
CGCGCAGGGTATGTGGAGCGACGAACGCGGT	Mycobacterium neoaurum
CTCGTCGCGGGCCTTCAGGTTCGGGCGGACC	Mycobacterium neoaurum
GTGCTGAACAGGTCGCGGGCCTCACCGTCGG	Mycobacterium neoaurum
CGCCCCCGACCCGCAGCTGACCGAGCCGGAA	Mycobacterium neoaurum
GATCCCCGGCGAACGCTATGCCGTGCTGAGC	Mycobacterium neoaurum
CCAGGCAGAGTTCGGCGGCCGCCTCGCGCAC	Mycobacterium neoaurum
ATCTCGAGGCGGTGCGCGTACTGGGTCGGCC	Mycobacterium neoaurum
CCAGACTCGTCGAAGCGCCGCTGTGGGTGCC	Mycobacterium neoaurum
TCTCGCTTCTTGCGCTCGCGCAGGCCATCTC	Mycobacterium neoaurum
GGGCGCGAAGCCGGGATCCGACTGACCGAAC	Mycobacterium neoaurum
GCACCCATCTCGCGATGTCGTCGTAGACGTA	Mycobacterium neoaurum
TCAGGACACCGCGCAGCGCGGACAGCCGGGC	Mycobacterium neoaurum
GCAGCGCGGCGATACCGTGGTGGCGCTGGGC	Mycobacterium neoaurum
GCTGCGTCCGCTCGACGGGGCCGAACCGGCG	Mycobacterium neoaurum_A
TCGCCTGCGGGAGCGCATTACTGCTGCCCGG	Mycobacterium neoaurum_A
ATATTCCTGCTCGGCCGGTACCAAGAGGCCC	Mycobacterium neoaurum_A
GCAACCAGGCAATCTGTGACTTCGCGGACGC	Mycobacterium neoaurum_A
ATGAACAAGCAGGTCTCCGCCGAGGTGCTGA	Mycobacterium neoaurum_A
GACTACCGCACACGGTGGACCATCCCGGTCG	Mycobacterium neoaurum_A
TCAGCCGCCACCTACACACCGCCGGCCTAGT	Mycobacterium neoaurum_A
CTTCAACTGGGCGGTGTAATACAGCTCGTTG	Mycobacterium neoaurum_A
GCACGCACCGTCGAACGCCGCGCAGCCCGTT	Mycobacterium neoaurum_A
CACCGCGGCCTTAATGACGACGTCATCACCC	Mycobacterium neoaurum_A
GTCGGCAACTACCGCATGTGGACTGCAAGGT	Mycobacterium neoaurum_A
GCATCGACCGCCGCGGTGGTCCCCGTGACGT	Mycobacterium neoaurum_A
GCCCGGTTGTTCCGCGACGCGGACGCGCTGC	Mycobacterium neoaurum_A
GCAGGACTTGCGATGACCGTCGAGCGCACCG	Mycobacterium neoaurum_A
AGCTCGGTATCGAGCTGCCCGAGGTCGTGGC	Mycobacterium neoaurum_A
GGTCAGCCGGCTCCTGGTGCTGATCGGTAAC	Mycobacterium neoaurum_A
GCATGATCCTATCGAACAATTGTTCGATAGG	Mycobacterium neoaurum_A
CTCGTCTGGGTCCTGGTGCTGCTGACGCTGG	Mycobacterium neoaurum_A
ATTGCCGGCCGGAATCTTTTCCGGACACCCC	Mycobacterium neoaurum_A
ACCGCGCGTCGGCGTCGGGTAGGTCCAGGCT	Mycobacterium neoaurum_A
GGGCGGTCCTCGCGTTCATCCGTTCGGTCTC	Mycobacterium nonchromogenicum
GCTTTACGGCCGTCGAACGACGGCGCCACCA	Mycobacterium nonchromogenicum
GCTGGTCGCTCGTTCGGTTGCCAAGCGCCGC	Mycobacterium nonchromogenicum
TCTGGCACAGCTTGGCCATCACGCCACCCTC	Mycobacterium nonchromogenicum
CACTTCCCCCTCGATGCCACGATGGTTCCGG	Mycobacterium nonchromogenicum
GGACAGTCTGACCAAACACCTGCTGCGCAAG	Mycobacterium nonchromogenicum
TCAGCCCCGCCACGGTCAGCGCCATCGAGAA	Mycobacterium nonchromogenicum
TCGCGTGCAACCTTGGTCTGCTTCGCCTTAG	Mycobacterium nonchromogenicum
CGTACGCGACCTGGCTGCGGGGCGCCGGCAC	Mycobacterium nonchromogenicum
GCTGTGAACGCGACCGGAGGCGTGCCCTGGC	Mycobacterium nonchromogenicum
GTGCGGCGTCGAGTTCAGCAACCCGAAGGCG	Mycobacterium nonchromogenicum
CGGCGTGGGTGCGATTACGTTGGACGGCAAG	Mycobacterium nonchromogenicum
AACGGCCCGGTGGCCGCACGCTCGGGGTCGA	Mycobacterium nonchromogenicum
CTCACCGATCCGGTGATGTTCCCGGTGGTGC	Mycobacterium nonchromogenicum
AACGGTCTGGAGCCGTGCATCGCACGGGCCA	Mycobacterium nonchromogenicum
TGGTCACCGGGCGGCTCAAGGACGTGATCAT	Mycobacterium nonchromogenicum
AATAGGCCGCATGCCAGGGCAGGGCCACGAT	Mycobacterium nonchromogenicum
AGTCCGATCCAGTACGACCAGATGCAGTGGT	Mycobacterium nonchromogenicum
AACTCACCGAGTTCGCGCTCGGCTTCGGCCA	Mycobacterium nonchromogenicum
CTGTTTGGGAAGGACCCCCAATGACCGAACA	Mycobacterium nonchromogenicum
ACGGCATACCCGGATCAACCGAGCACTAAAG	Mycobacterium noviomagense
CGGTGGTGTAGTTCCAATAGACGGTCGGAAC	Mycobacterium noviomagense
GGCCGGGTCTTCGTACCTCAAGACTTCCTGG	Mycobacterium noviomagense
AATCTTCTTGTCCCCGATAAATCTTGGGTTT	Mycobacterium noviomagense
TGCCCGCCTTTGAGCGATTAGGTCATCTAAG	Mycobacterium noviomagense
GATGATGTACTTGTACAGCTGCAATTGGTCG	Mycobacterium noviomagense
GTTCCAACCGCTCCAGGACCCGCACGCGTAG	Mycobacterium noviomagense
GGGAATGTGGCCGCCGCGCAGCGCACCCTCT	Mycobacterium noviomagense
CCGACGAGGGCACCGCTCGGTTGGCGCTCGA	Mycobacterium noviomagense
CCAGCATCCGCCCGTTGACGCTGAACGCGTC	Mycobacterium noviomagense
ACCGACGCCGAAGCAGAGCGCCTGCGCGCCG	Mycobacterium noviomagense
CTCCGGGTCCTCGAGTACCACCAGGTGGTTC	Mycobacterium noviomagense
CTGCGTCACCCCCTTCCCGCCTTCCTCTGGC	Mycobacterium noviomagense
ACGGTAGAGATCACGGAGTGAACGTGCCGCA	Mycobacterium noviomagense
CTTCGAGTTTCTCTTGTCCCCCAAGCAGATT	Mycobacterium noviomagense
CACCGGCCGCGCGCTTCGTCCGGGCATGTCG	Mycobacterium noviomagense
GGCGGTGTTGGGATAGTAAGTGTACGTGGAC	Mycobacterium noviomagense
TGAACTCTGCGGGCAATGTCATCGACCAGGC	Mycobacterium noviomagense
ACCAAGGTCCACGCCGCAGAAGCTACGCCAG	Mycobacterium noviomagense
CCACCCCGTCCCGGTGTGGCTGACCAGCCTT	Mycobacterium noviomagense
ACGCGGTGATGATCGGCTCCCGCAGGTGACG	Mycobacterium novocastrense
CGAACCGACGCACGTGCTCTTCATGCCGCGG	Mycobacterium novocastrense
CGCTGCCGGTCGGACAGGTCCGGATGCGGAT	Mycobacterium novocastrense
TCCGGCGCAACCACGATTTCCTGTGGAAGAC	Mycobacterium novocastrense
GAGCCGTGGCGCCGCCGACATGATCGGGCGC	Mycobacterium novocastrense
GATCGCGGGTGCGGATCACCATCGTGCGTGA	Mycobacterium novocastrense
GAATTCCGGTGGGCGAGCTCGTCGAGACCAT	Mycobacterium novocastrense
TGATCCAGCAGCACTGCCAGACGCCGAGCAT	Mycobacterium novocastrense
AGGTCGGACACGCCGGGACCCTTGACCCGAT	Mycobacterium novocastrense
CAAGGCCAAGGATCGCAGCCCCACCGACGTC	Mycobacterium novocastrense
GGCTTGCTGCCCCATGCCGGAGGCGGCCCCG	Mycobacterium novocastrense
GCCAGGCCGAACCGCGGTGCGGGAAGGCCCG	Mycobacterium novocastrense
CGTCGACCGCCCGTGCCGTGAGGATCAGATC	Mycobacterium novocastrense
ACAACGAGACCACCTACGGCGGCCGTTGGGT	Mycobacterium novocastrense
CTACGGCGACGGCAGCGTCAAAGACTGTCTG	Mycobacterium novocastrense
GACGCCATGCAGCGTGAAGCCGCAAAGGATG	Mycobacterium novocastrense
CCCTTCGCGGCGGATTCCGTCTTCGGGAACG	Mycobacterium novocastrense
CCGGAACCACGCCGGAGGAAGCGGACATCGC	Mycobacterium novocastrense
GACGAGGCCAATCCGCGTCTCGCCGTCCCGA	Mycobacterium novocastrense
TGCAGGCCGTGATCCGCTACGTGGAGGCGAC	Mycobacterium novocastrense
CGAACCGTCACGTCGGTGCGGGCGGAGATGA	Mycobacterium obuense
CGGCGTCGGTGGTGCTGACCGCCGCCGCTGC	Mycobacterium obuense
GGTCGCCGGCCTGGCCACGATGCTGATGGGC	Mycobacterium obuense
ACCGCGGGTGGGACATCGCCGAGCTGTTCGA	Mycobacterium obuense
CGCCGTAGCGCGACGCAGGACGGTCGAGGGG	Mycobacterium obuense
CGACCTGATGCGGGTGCGACGCCGCCCGGAC	Mycobacterium obuense
GGGGTCGACGGGTGCCACGCCGGTGCAGAAC	Mycobacterium obuense
CGGATCCTCGCCGATCTGCCCGAGCCGACAG	Mycobacterium obuense
ACCGAGCACGGTAGCGCTTTGACACCGTGCA	Mycobacterium obuense
CCAGCGCGCTCTCCCCGAGCAGCACCGACGT	Mycobacterium obuense
TTCACCTGGTGATCCGACCGCCCGACATAGC	Mycobacterium obuense
CGAAGGGGCCCGCTCCACCCGAGGTCTGTTC	Mycobacterium obuense
GACGGTCCGATCGATGCCGAGCGGGTGGTGT	Mycobacterium obuense
CGGTCCTCCTCGCCGATCCCGCCCCACAGCG	Mycobacterium obuense
TGATCGTCGGCGCAGCGGTCGCGCTGTTGAT	Mycobacterium obuense
CCGGCGCCGCGAGCGCGACGTTGGCGCGGAT	Mycobacterium obuense
ATCAAGGTCGCGCACACCCTGCAGGGTGACC	Mycobacterium obuense
CGTGGTCGAGCAGGCCGGCGCGGATGCGCTC	Mycobacterium obuense
CGAACGGCGTGACGGTACTGCGGTAGTTCTC	Mycobacterium obuense
CTTCCGGACTGGTTGTGGCAGCTCAACATCG	Mycobacterium obuense
ACCGCCTCCACCGCCCGAGACTCCCGCCCCC	Mycobacterium ostraviense
AGCACGGCGTCTTGGAGCGGACTGGGCCACG	Mycobacterium ostraviense
AAAGCCGAACGCAGGTTGATAGACGGCGCGT	Mycobacterium ostraviense
CACCCGGCACGGACGGCAACCCTGGCTGACA	Mycobacterium ostraviense
CCGGCGTCCACCTCGGCCGACAGGGTCAAAT	Mycobacterium ostraviense
CGGCTGCACGGTGTCGACCGGCTGCGAATGG	Mycobacterium ostraviense
CACCTTGTCCAGTGACGACCACTATCAAGAA	Mycobacterium ostraviense
CATGGCGCTACATCCGGGCTGCGGTTCCCGC	Mycobacterium ostraviense
TGTTTCCCGGACGAACTGGGGGCTGGTCTTG	Mycobacterium ostraviense
GGTGCGTCGCGGGAGACCGCGAAACGCTTCG	Mycobacterium ostraviense
ATCCTGGTGCTGGCGGCGCTTGCCGCCGCCT	Mycobacterium ostraviense
GCCATGCCCAGGAGCCAGCCGGCCAGCACGT	Mycobacterium ostraviense
GCGACGTCGGCCCGATCGGCGACCGCGCGCA	Mycobacterium ostraviense
GGATGCCTTCGAGGGGATCGTCGAGGGGATC	Mycobacterium ostraviense
TGCGCTACCTCGCGCGGCAGTCGGTCGCCAT	Mycobacterium ostraviense
GCCCGCCGACAGCACCTGGCCGATCTTGTCG	Mycobacterium ostraviense
CCCCGCCGACGTCGGCTCACCGAAACTGCGC	Mycobacterium ostraviense
GTGGAATATGTGCCGGAACTGCTTGTGACGA	Mycobacterium ostraviense
CAGCAGGGCCGCATCGATGGCCGGCAATGCA	Mycobacterium ostraviense
CCGAGCAGCCCCGGCAAACTTTCGTTTCTCG	Mycobacterium ostraviense
CAGCAGGACGTGCTGTTGGACGACGTGCTGG	Mycobacterium paraense
TGGCCGGGAGATCTACACCCGCCTCAACCTA	Mycobacterium paraense
AGCGGCTACATGATCAAAGAGCATCACGACG	Mycobacterium paraense
AACGGCGTCGTCTCATGTTCGAGTCGTGTCG	Mycobacterium paraense
CAACCGCATGCCGGCGGAGGCCTGAGCTGCC	Mycobacterium paraense
GCCGTAGGTGTTGCGCAGGAACGCGTCGGTG	Mycobacterium paraense
ACGCCGGCGCGCTCGCCTGGGAGCGGGTGTA	Mycobacterium paraense
CCGCCGCCGCGGCAGTTAAGTAGCCGACTAC	Mycobacterium paraense
GCACCCGGGTGCGCTCGTCGCCGGATGTGCT	Mycobacterium paraense
CACCTCGTTCGCGCGGTCGAGGTACAGCGAG	Mycobacterium paraense
TCGCCAACCAGGTGCTCCACGCGGCGCCGAT	Mycobacterium paraense
GGCTCACCCCACCCGTCGGCGGCCACCATGC	Mycobacterium paraense
TGATCGCACGGTCGAGGTTGACGGGGATCCC	Mycobacterium paraense
CCGAGGAGGACGATGACCGAGACCTCGACCG	Mycobacterium paraense
GCTCGTAGTAATCCTTCGGCAGGAATTCCGT	Mycobacterium paraense
CGCACAGTTTAACTTCCGGGGGCTGGTGGCG	Mycobacterium paraense
GGTCGACCCCGAACTCGTCGACGTCGCCGAA	Mycobacterium paraense
TCGGTGTGGTGCATGGCGAATTCGGCACCCG	Mycobacterium paraense
CTCGGGCGCGCCGCCCGGGCGGGGGCGGTCA	Mycobacterium paraense
GCCCCGCGCGCAAAGGCGCGGCTGAGGTGCA	Mycobacterium paraense
TACACGATCAGGCTGGCGGCCAGCCCGTAAT	Mycobacterium parafortuitum
GCCCTGCCGCGGCCGAGCCGGGTGCGGACCC	Mycobacterium parafortuitum
ACGTCCATCTTTTCGAGATCGGCGACGGCGC	Mycobacterium parafortuitum
GGCTGAAAGCCGAAACGCGAAGTTCGGGTTC	Mycobacterium parafortuitum
GGTGCTTGGTGGCCGGTCAGGCGCACGATCT	Mycobacterium parafortuitum
GTAGTCCGGCAGGTCGTAGCCCTTGGCCCGG	Mycobacterium parafortuitum
CGCGCGTCGGGAGCACCCAGCGGCGACTTCC	Mycobacterium parafortuitum
CGCGACTGATCCGGCTCCCCGGCGTCGGCCA	Mycobacterium parafortuitum
GGGCAGGGTGCTCACGTCACACTCCGATTCT	Mycobacterium parafortuitum
GCGGAGGTACCGGGATCCGGAAACGCGGCCT	Mycobacterium parafortuitum
CGGGCGCGGGCGCCGACGCGGCCGCGGACTT	Mycobacterium parafortuitum
ACAGCGACGGCGTGACCACATGCTTGCCTGC	Mycobacterium parafortuitum
TGCGGGTGCCAACCCGGGAATGGAGTTTTGA	Mycobacterium parafortuitum
CGCGAAGGCCGGGGTCGGCCCGGCGATGCGG	Mycobacterium parafortuitum
CAACGCCGGCTGGGTGTCCCCGGCGCTGACC	Mycobacterium parafortuitum
CCACCGCATCGGCATCAACCTCCGCGACCTC	Mycobacterium parafortuitum
CCCCTGCTCGAGCGCCGCGATCAGCGCGAAG	Mycobacterium parafortuitum
GCGCCCGGCCGTTTCGAGGCCAGCACGGTCT	Mycobacterium parafortuitum
CCTTCTACACTTTCTCTGTGCCCAATCCGCC	Mycobacterium parafortuitum
GCTGCCGCGCACCACGCCCAACACGATGTCG	Mycobacterium parafortuitum
CATGGGAGGCGCTCGAGCGTGCCGGCATCGA	Mycobacterium paragordonae
AAGGTCAATGGTCATGGCGTCGACTTTCGAC	Mycobacterium paragordonae
ACCTTCACTCCGACCGATCCAATCACTCTGT	Mycobacterium paragordonae
GATCAGCACCGCCAGCAGGGCCGCGGCGAGC	Mycobacterium paragordonae
CCGGTTGTCTGCTCGGGGGACTCGCCTTGGG	Mycobacterium paragordonae
GATGTAGTCACCGCTGACCGTCACGCGTTCC	Mycobacterium paragordonae
TCGCCGGTGGCGAAGACGCCGATCGCCTGCT	Mycobacterium paragordonae
AGTCCATCGACGGTCGCTCGGAACATCAGCG	Mycobacterium paragordonae
ACCTGATACGACGACAGTTCAGGGAACTTGG	Mycobacterium paragordonae
CCGGCAGCACCATTTTCGACTTCGACCGGAC	Mycobacterium paragordonae
GGAGCTGGTGTTGATGATGCGGGCATGCAGG	Mycobacterium paragordonae
TCAAGGAGCAGTCACATGGGGGATTCACCGG	Mycobacterium paragordonae
CCACCAGGATCGTGCGCACCGTCCCGAGGTC	Mycobacterium paragordonae
CGCCATGCGCAACACGGTGATCTACACGGTG	Mycobacterium paragordonae
AACGAATTTCGCTTTCCGGATCTTATCCAGA	Mycobacterium paragordonae
GATCACCGGGTGCACGAATTCGACCGCGATG	Mycobacterium paragordonae
AACGGCGGCTCCGGAGGCAACGGCGGTCGAG	Mycobacterium paragordonae
ATCGGGGGACAACGCTGAGATCGCCGATGGG	Mycobacterium paragordonae
CGCGGCCGCCGATCCGACCGGAGTCGCCTTC	Mycobacterium paragordonae
TGCTGGATTTCACTCCGACGGCCGAGGCGCA	Mycobacterium paragordonae
ATAGATCGAGGCGATCCGGTGGCCGACGAGC	Mycobacterium parascrofulaceum
GTTCTTCTCCATCGACCCGGCGTCGCTGCGA	Mycobacterium parascrofulaceum
TGAGGAAGCACCGGCCATGAACACCCCCGAG	Mycobacterium parascrofulaceum
GAACGCCGAAGCCACCGCCACCGCGGCCAGG	Mycobacterium parascrofulaceum
GGCACCTTCGACGACGCGCAGGTCGCCCTGG	Mycobacterium parascrofulaceum
CAAGGGCGTCAAGTCGATGCTGGGCCCCGCC	Mycobacterium parascrofulaceum
TCCGGGCGAACCAACCTCCCTCCCGCCACCA	Mycobacterium parascrofulaceum
CCAGCTGCTCACCGAGCCGGTCGAACCGCTC	Mycobacterium parascrofulaceum
CTTCGATCGCGTGCCGCAGGCCCTCGATGCG	Mycobacterium parascrofulaceum
CGCCGGGCTGCAGGGTGCGGTGCAGGCCGCC	Mycobacterium parascrofulaceum
GGTCTGGGGCCCGGCCTCGTTGAGCAGACGC	Mycobacterium parascrofulaceum
CCACCCGCTGGTAGTAGTCGGCCGGAACTCC	Mycobacterium parascrofulaceum
TCATGACCGCCGACGCACCGGCGGCCGCTTC	Mycobacterium parascrofulaceum
GTGACGCGGCCGCGCGGCGAGGGGGCGTACG	Mycobacterium parascrofulaceum
CTCGCCGGACGGGGTGTAGCACGGCGGCGGT	Mycobacterium parascrofulaceum
GTGTCGCGCAGGGCGAACCACACCGTCACCA	Mycobacterium parascrofulaceum
CTTCGGCCCGGCGGCCCGCGCGCTGGCGCAG	Mycobacterium parascrofulaceum
CGCTGGTGATGGACGGCGCGACGGCGACCCT	Mycobacterium parascrofulaceum
CGGCGTCGTCGATACTAGCCGGTCGGTGGCT	Mycobacterium parascrofulaceum
GTCCCCTGACCACCGGTGGGTTGCGGGTCAC	Mycobacterium parascrofulaceum
ACCTGGGATTCGGTGGGGTTGCGGGCGACCA	Mycobacterium paraseoulense
CTTCAACGAGCCGTTCAAGAGCTTTTGGCTC	Mycobacterium paraseoulense
CTCGGAGATCGCCGGATCGAACCAGTACTGT	Mycobacterium paraseoulense
CGCACGAGCCCGAGACCCACGCGCTGGCCGC	Mycobacterium paraseoulense
CGCCACGGTCGCGCGGATCGGAGCGTCTTTG	Mycobacterium paraseoulense
TGACGATGTATTCGCGCAACATGGGGCCCAC	Mycobacterium paraseoulense
CGGGGCAGCCGCACGACCTGCCAGCTGGCCA	Mycobacterium paraseoulense
GGGTGCTCGTCCAGCACGCGCCACAGCCGCA	Mycobacterium paraseoulense
ACGAGTGCTGGTTTACGTCGACCGTGGAGGA	Mycobacterium paraseoulense
CAGACCCATGCGTTCCATCACGCCGGGGCGA	Mycobacterium paraseoulense
GTATTTCAGCACCTGGGGCAATCAGACCATC	Mycobacterium paraseoulense
CGGATCGGAGAACGAACGCGCTCCTTTGAGC	Mycobacterium paraseoulense
TCGCGATGTACTGGACGCCATCGCCGATCCG	Mycobacterium paraseoulense
TCGGGTCAGCGGGCATTGTTGTGGGCCGCCG	Mycobacterium paraseoulense
AGGCGCACCGACGACGGGGTGCTGGTGACAA	Mycobacterium paraseoulense
ACCTGCTGTGGCTGGGCGCGGCGGGGCTGAT	Mycobacterium paraseoulense
ATCCGGCTGATCGCGCACCTGCCGCTGGATG	Mycobacterium paraseoulense
CCGGATACACGCGTTCATGTCCGAGCGGGTG	Mycobacterium paraseoulense
GACCGTGGCGATCGCCGTCATCTGCATCGCC	Mycobacterium paraseoulense
GAAAGCCCAGTCGCTGGTCCAGTTGGTGCCG	Mycobacterium paraseoulense
CGCAGCGCGCGACCGCGACCACGACGTGATC	Mycobacterium parmense
TGGCGAAGGTGCGCTACGACCGCCTCGGCGC	Mycobacterium parmense
TGTACTGGTTGTTCGGCGGCTTCCTGCGTCA	Mycobacterium parmense
CGGCGCGCTGTGCCCGATCCGGCAAATCCCG	Mycobacterium parmense
GTCACACACCGCCGCCACCGAGGCGATCGTC	Mycobacterium parmense
GGTCGACCATTCCCCAGGTGTTCCGGTCTGC	Mycobacterium parmense
AAGTGTCTGTAGTGACTGGTGTGAATACGCC	Mycobacterium parmense
CACGCCGGCCAGGCGGCGTTCCCGGGCGGTG	Mycobacterium parmense
AGTTCACGCGGACCGTCGACACTGACACCGA	Mycobacterium parmense
AGTTTCCTGCGCCATCACGACCACGACATCC	Mycobacterium parmense
ACCTCGGCGGGTTCCCCGACCAGGAAGAGCA	Mycobacterium parmense
CATGGCGAGCGTGTCGCCCGCAGACTCGACC	Mycobacterium parmense
CCTCGGCCTTCTCGCCGTGCCCGCGCCCGGC	Mycobacterium parmense
AGAGAAGCCCCGGATGACCTTCTCGCTCTAG	Mycobacterium parmense
GCCGGTCGACGAGATGCACCCGGCCGGCGTC	Mycobacterium parmense
TGCGCGAAACCCACATTATTGCGCCATGGTC	Mycobacterium parmense
TGAGGGCCTTTTCCGCGGCACGCCGTTCGTG	Mycobacterium parmense
GCGCGGAAGAACCGTCGCGGCAGGTTCGCCT	Mycobacterium parmense
GACGGGCTCAAACAACTAGTCCGGAAAATCG	Mycobacterium parmense
GGGCGGTTTTCTCAAGGTCAAGCCGTGGTCG	Mycobacterium parmense
GGTCGCCGCGCGGCGCAGTGACGACGTCGCG	Mycobacterium peregrinum
CGACAGGTCGCCGACAAGAAGCCCAAGGACG	Mycobacterium peregrinum
GCGGGTCTGCTCGGCGGCGTCGCCGCCGCGA	Mycobacterium peregrinum
CCGCCTGCCTACTCCTCGAATACGGAGTATC	Mycobacterium peregrinum
GCGACATCTGCGTGCAGGCATGCGCCAACGA	Mycobacterium peregrinum
CCGTTGCACCTTCATCGAGCAGGCGGGCGAC	Mycobacterium peregrinum
GCCGGACGGCTCGACTGGGCCGGAACGCTGA	Mycobacterium peregrinum
CACCGAAACCACCCCGGCACAGGAACGTCAC	Mycobacterium peregrinum
GGCGATCAGCGCCGGCTACAGCCCCGGATTC	Mycobacterium peregrinum
CTTCTTCCGCAAGGCACCCGACCTCGGTCGC	Mycobacterium peregrinum
TCGGATCCGGATCGCCCCGTGGCCCGGGGCG	Mycobacterium peregrinum
GCGCGGCCGGCACCTACCTTCCGCAGGCGGT	Mycobacterium peregrinum
CCAGAAAGGCGTCGGTACCTGGCACGGTCAG	Mycobacterium peregrinum
GGATGTCGAGAAACGCCATTGGATCACTTTC	Mycobacterium peregrinum
CGATCCGGTCTGCCAGCACCCGCGCTTCAGT	Mycobacterium peregrinum
AACCGGTCCCCGAGATCGTATGGAGGCCGGT	Mycobacterium peregrinum
CCGGGTTCATCGGACCGTCACCTTCACCGCC	Mycobacterium peregrinum
CGAGGACGGCACCATCCAGGGACTGCTGGAA	Mycobacterium peregrinum
CTGCGATTCGGTGGACATCGTCTCCGGAATC	Mycobacterium peregrinum
CCCCGTACACCCAGATCTCACCGACCGAACC	Mycobacterium peregrinum
GGCGTCCGGGCTGGACTGCGTCCTTGACGGG	Mycobacterium peregrinum_B
ACGCCGCAGCTCGTCGGCGGTCAATGAGCGG	Mycobacterium peregrinum_B
CCCGGAAAAGTACGGTCTGACCGCCACAGAC	Mycobacterium peregrinum_B
CGCTCCTCACGCGGCCGAGGGCATCGGCACC	Mycobacterium peregrinum_B
GCAGGGATTCCCGCCAGGTGCCGGCCTCGAT	Mycobacterium peregrinum_B
CCAATGCGATCGGCGGTGAGCAGCGCGTCGG	Mycobacterium peregrinum_B
ATTGCAGCTGCCGTCGGGTCTTCACGCCGGG	Mycobacterium peregrinum_B
GGCCGTCAAACAGACGCTGGCGACGTTGAAA	Mycobacterium peregrinum_B
GGCACCTCGGAACGATGCCTGCTGATCACCG	Mycobacterium peregrinum_B
GCGAAGAATCGTTCATCGCGGATCGAGTACC	Mycobacterium peregrinum_B
ACGACGATGCCGGCCAGCACCCACGGCGCCG	Mycobacterium peregrinum_B
TAGGGGTTTTCACCGGCATCGGCCGGGTGAA	Mycobacterium peregrinum_B
TCGGCGCGGGTACAGGATGCCCTGCTGGCCG	Mycobacterium peregrinum_B
GTCCGTGAAATCGCCCATCCGATCCAAAACA	Mycobacterium peregrinum_B
TGTGGGTGAACAGGTCGCCGGCCAGCAGCGT	Mycobacterium peregrinum_B
AGCCACCGCTGATTCCAATGGCTCGCCGCCT	Mycobacterium peregrinum_B
TCGCCCACACCAGCATGGTCAGCCCGGTGTC	Mycobacterium peregrinum_B
AACACGGCTTGGGGGTGACTTATGACACCTG	Mycobacterium peregrinum_B
TGCGGCCGTCCCACAGTGCCCATGCGGTCAC	Mycobacterium peregrinum_B
CGGAGCGGGCACGCTCCACAACACGCGGCCG	Mycobacterium peregrinum_B
CGACCCCGCCGGTGACAACACCACCGGTGAC	Mycobacterium persicum
CTCGGTTTCCGTGGCATTCGTGCCTATTACG	Mycobacterium persicum
TGATCCGCCCGGGACGCCTGACACCGCCTCG	Mycobacterium persicum
TCGGAGGTGGCCGCGCAGTTACCGTCGTGGC	Mycobacterium persicum
ACCCCATCGGCTTCGCGGGAGGTTCACAGTG	Mycobacterium persicum
GACCGCACGGAATCGATGATCGGCTCGTCGG	Mycobacterium persicum
AGGCCCGCGATGGGGTGTTTAGGGTCGATAA	Mycobacterium persicum
CCCACACGGTTCCAAGCAGGCCGGCCACCGT	Mycobacterium persicum
GCTTGCCGTCGGCGCCAACAGCAATGCCACC	Mycobacterium persicum
CGCAAGGTCCGCGAGCGTGCGGCCGCCGCGA	Mycobacterium persicum
CACCACAATTCGCCGGCCTGGGTACCGGGGC	Mycobacterium persicum
TTCCGAGACGTCGGTTCGCCGGCTGGCCCCC	Mycobacterium persicum
GCCATCGAGGCGTACCCGCGCACCACCACCT	Mycobacterium persicum
CCGGTCGCACGTCGGTATCAATCCCCGACAC	Mycobacterium persicum
GACAATGCCGATGGCTACGGGCTTACCGCCC	Mycobacterium persicum
GTGGCATTCGCCGGCGAAGACCAGCACCAGG	Mycobacterium persicum
AACCGCCGGCTGCCGACCTGACGTCACGCCG	Mycobacterium persicum
GGCGGTGGTGGTCGTCGCGACGGTGGCACTG	Mycobacterium persicum
CTGCACGACCTGCGGCCCGGTTCCGGCCCCG	Mycobacterium persicum
CATACCAGCCCGACCTTGAGCGTCCAGGACG	Mycobacterium persicum
GCGGGCACCGGTGCGGGGGCCGGCGCCTGCT	Mycobacterium phlei
CGGCCACGGCGGCACCGTCCCGATCACGGTG	Mycobacterium phlei
TGACGCCTAACGAACTCAGCGGTGCCGTCGG	Mycobacterium phlei
CGCCGCACTGTGGTTCGCGCTCGACACCGAT	Mycobacterium phlei
GGCCGGGCTGGCCGGCGAGACGTGGACCCGC	Mycobacterium phlei
CCCCTATCCCCCGTTCCTCGGCGTGGCCAAC	Mycobacterium phlei
GGTCTTGGCGGCCAGCGCGAAGATGCGGCCC	Mycobacterium phlei
AAGACGATCCGCACGGTCGCCGTCGGCGCGG	Mycobacterium phlei
CAGCGGGGACCCGGCACCTGATCCGCCACGA	Mycobacterium phlei
GCGCGCTGCACCTCCTCGGCGTGCGCGGCGG	Mycobacterium phlei
GTAGCGGCTCATCGTGATCGACTCCTCCGGA	Mycobacterium phlei
GCACAGCACGACCGCGGCGCGGAACTCCGGG	Mycobacterium phlei
CCAGGAGACGCTGGAGGCCATCGAGGAGCTG	Mycobacterium phlei
ATCCGCCGTGGGCGCCACCGTGTTTGATGAT	Mycobacterium phlei
GCGACCCGCGCACGCCAGGCGTCGTCGCCGA	Mycobacterium phlei
CGCGGCTTGGTCCTCTCCGGGTTCGTCTCCC	Mycobacterium phlei
CGACATCCTCGACGACTTCCTGGCCCCCGGC	Mycobacterium phlei
GATCAAGGCCCCGATGAACGGCTTACCGTCG	Mycobacterium phlei
CCGACCGGTACGGCATCTCCGGGATCGAGGA	Mycobacterium phlei
CAGGCCGCGGGCGAAGTGCACCAGCGACGAA	Mycobacterium phlei
ACCGGATTCTCGCCGTCCTTGCTACTCGGCG	Mycobacterium phocaicum
CTGGATCTGCGGCGCCTGATCGACCGGGCCG	Mycobacterium phocaicum
CGACTACCTCCGCCGCGAACTCGACGAGCTG	Mycobacterium phocaicum
ATGACCCCGCGTGCGCAGAGGTGCTCGGTCA	Mycobacterium phocaicum
GTCCGACATGCAGGCCCTCGCTGCCACCCGC	Mycobacterium phocaicum
GCGATCATCTTCGCCACGTCGGTGGACGTCG	Mycobacterium phocaicum
ACTTCGTCGTCGGCCACTGCCACGTCGGTGA	Mycobacterium phocaicum
TGCCGGTCCACCTGACAGGTGGAAACAACAC	Mycobacterium phocaicum
TCTGTTGCAGCACCTGTGGAAAGCCGAGCTC	Mycobacterium phocaicum
GCGTGGGACACCCCGCTGGTGTGGCGTGACC	Mycobacterium phocaicum
TCGTGGCACAGGAATTGGCCAAGAACCACGA	Mycobacterium phocaicum
GATCACCTGGCCGGTTTGACGGTGCGTCAGT	Mycobacterium phocaicum
GCGATCCGGCGCTGTGCACAATTGCTTGTAT	Mycobacterium phocaicum
GGCGGCCTGCCGGTAGGGCGTGCCGTCGATC	Mycobacterium phocaicum
TAGGTCCCGCGTTTACTGGATGAACGGAGTG	Mycobacterium phocaicum
CCTAATCGGCTCTCATCTCACGCCTAGGCGG	Mycobacterium phocaicum
GGCAACCTGCTGTACCAGCTCGAGGTGATCC	Mycobacterium phocaicum
GCTTGAGCAGTTCGTCCGCGAGTTCATGCTG	Mycobacterium phocaicum
CCATCCATGAGTATTGGAAGGGAAAGACATG	Mycobacterium phocaicum
TCGGCGGTCAGTGGCTGCCCGGGCAGCAGCG	Mycobacterium phocaicum
CGGGTGCCTCGCCGGCGGTGCCGACGACCTC	Mycobacterium porcinum
CGCGGTCACGCCGAACATTCCACCATCAGAC	Mycobacterium porcinum
CACAGTGGTTGGGACTGCATGCGGAACATCC	Mycobacterium porcinum
CCGGGACAGTCGAAACCGCCGTCCTCGTGGT	Mycobacterium porcinum
GATGAACGTCAGTCCTGGCACACTCCAGTGC	Mycobacterium porcinum
GCTTCGCGGGCCACCTGGTGAAGGTGTCGAT	Mycobacterium porcinum
TGTTTTCTTTGGCGCTACCCATGCGCTCACC	Mycobacterium porcinum
GCCCGCGGTCTGAACGGAGATGTTGGTGTAG	Mycobacterium porcinum
CGGACGGGAACGACGTCGAGAGCGCGTGGAC	Mycobacterium porcinum
AGTCCGTGGCGCTGGTCTGCGGAGACCGATC	Mycobacterium porcinum
GCAGCGAGACGCCGAGAAAGGTGCCCTGTAC	Mycobacterium porcinum
TGTTCGCCGCCGTCGTCGAGGCGGCCAGAAT	Mycobacterium porcinum
ACCACGCTGTCGAGAAGTTCCTCGCCGAGCA	Mycobacterium porcinum
GCTCATCGTCGGTACCGATCCGTCCTATCCG	Mycobacterium porcinum
ACGTATCCGCTGTTTCCGGCCGCGGCGACCA	Mycobacterium porcinum
GGCGATGTCAACGGACCGACCCGCGGCGTGG	Mycobacterium porcinum
GCCACTGCGGCCATGGCGGCGCCGACGGCGG	Mycobacterium porcinum
TCAGGTGCTCGGGCCCGCCTGCGCCACCACC	Mycobacterium porcinum
TGCTTGCGGGTGACTCCCAGCGCCCCGGCCG	Mycobacterium porcinum
CGGTGTCAGCCTCGATCGCGGCGACGTGTGC	Mycobacterium porcinum
AAAAGATCATCGCGGTTGACACCGACGACAC	Mycobacterium pseudokansasii
GACTTGACCAGCTTGAGGTTGACGTTCATCT	Mycobacterium pseudokansasii
TCGACGGCTTCCAACGACAGAGCACCACGAC	Mycobacterium pseudokansasii
CCTCGGTGGAGTCGGCCGTCGAGGCGGTGCT	Mycobacterium pseudokansasii
CGTCAAACCAGCGCGGCGAGGTCGCGGACCT	Mycobacterium pseudokansasii
GCGGGCTATGGCCAGCCCCAGCTGGTCGCGG	Mycobacterium pseudokansasii
CGGCAAGCCCATAACGCGGCGCGCATACGCC	Mycobacterium pseudokansasii
GCATCCGCGACGGCCTTGGCGGCTTCGTCGA	Mycobacterium pseudokansasii
ATCGCAGCCGGCACCGCTTAAAGCGCATCTA	Mycobacterium pseudokansasii
CCCGCTCGGCTACCCGCTGGCCTGCCAGCGC	Mycobacterium pseudokansasii
TCACGTCGATGCGGGGCCGTCCCAGCTCGGC	Mycobacterium pseudokansasii
TGCCGATGCTGCCGGCCACCTGGGAGTCGAC	Mycobacterium pseudokansasii
GCCCGGCAGCTCAGAGATCAGCCCGGACAGT	Mycobacterium pseudokansasii
GGCTTCGGCGATGTCGCGCGCGTTCATCGCC	Mycobacterium pseudokansasii
GCCGACCTTGGCCATCGGCCGGCGGGTCAGC	Mycobacterium pseudokansasii
GGGATGACATAGCTGCGCGACTCGCTCGGGC	Mycobacterium pseudokansasii
GGTTGGTCAGAATCGACAGGCCGCGTTCTCC	Mycobacterium pseudokansasii
CCCGCTGGCCCGGCTGCGGCTGCGAATCGGG	Mycobacterium pseudokansasii
ACGCTGTCGAGATGATGAACGTGGGATCGCC	Mycobacterium pseudokansasii
GGTGCTCTTCCCCGGAGCGGGCTTCGTGGAG	Mycobacterium pseudokansasii
CACCGCGACCCACCCAGCGGCCTGCGGCCAT	Mycobacterium riyadhense
TCCACGCCGGGCGAACAGATCGCCGTGGCCG	Mycobacterium riyadhense
GGTACCGGCACGGTGTTGGGTGATCCGATTG	Mycobacterium riyadhense
CCGCGATGTGCACGGCGATCCCCCCGATGTC	Mycobacterium riyadhense
GGCACTTGGTGCTCAAGGCGCGTGGACCGGC	Mycobacterium riyadhense
GTACTTCACCTCAGAGATCATTCGCCACCTG	Mycobacterium riyadhense
CTTCCGCGTCGGCTGACCGATGCCACCCAAG	Mycobacterium riyadhense
GGGCGTCTCGATGTCGGGGTCGTCGGCGACG	Mycobacterium riyadhense
CTACGTTGAAGTCCCCGACATTGGCGAGCCC	Mycobacterium riyadhense
TGTTGCTGCCGGTGTTACCGAAGCCCAGGTT	Mycobacterium riyadhense
GTCGACGGGACCGTCGAAGAACCCCTGGATC	Mycobacterium riyadhense
CGTTGGGCGATGTGGGCCAGTTCCTTCTCGG	Mycobacterium riyadhense
CACCACCGCTGGACGGCGTGTCCCCACCCCC	Mycobacterium riyadhense
GATCAACGAAGTCGCCGGTGTGCTGGACACC	Mycobacterium riyadhense
ATTGCGCCGGACCGACTTTCTTCATGAGGCG	Mycobacterium riyadhense
GTCGAAGGCGGCTGGCACGCTTTCCGGCTGG	Mycobacterium riyadhense
CGGTGATCACGTCGTCGTCGACACCTTTGGT	Mycobacterium riyadhense
CGTTACGCCGCCGAGTCTGCGGGTTCGCTGA	Mycobacterium riyadhense
GAGGTTGGCTCGCAAACCGGTACGGAACGGA	Mycobacterium riyadhense
CCGAAGAACGTCACGGCCACCCCCAGCAGCG	Mycobacterium riyadhense
CTCGCCGAGAAGTCCACCGAGGCAACGGTAT	Mycobacterium salmoniphilum
CGCACCACGCTGATTGCGATCGTCACCAAGA	Mycobacterium salmoniphilum
AACGGTATCTGCAGTTGATGGTGCCCGCGGT	Mycobacterium salmoniphilum
ATGATCATCGCCAGGGATGTCTTGCCGAGCC	Mycobacterium salmoniphilum
TACCGCTCATGCTGTTGTTCAGCGTCGCGAA	Mycobacterium salmoniphilum
ACGGCGACGACCCCAACTGGCGCCCCACGCT	Mycobacterium salmoniphilum
GTACGGGCCTGACCGCCGACGTCATCCAGGA	Mycobacterium salmoniphilum
TGAGGGTTCTCGTAAGACTCACGAAGATCAG	Mycobacterium salmoniphilum
CGATGACCTCACGTCCGGCGCCCGCACGGGG	Mycobacterium salmoniphilum
TGTGGCAGCAGGGCTCCACCGTGCCGATGGT	Mycobacterium salmoniphilum
CTATCGCCGAGGGTGGTTCGTTCGCCTGTGG	Mycobacterium salmoniphilum
CTGGTTCATTCCCATGGCATTCATCTCGCTG	Mycobacterium salmoniphilum
CTCACCGCCGCGCTGACCGTGGACGCTCGCA	Mycobacterium salmoniphilum
GGAGCGACGGCGGAGCGATCGGCAATACGAC	Mycobacterium salmoniphilum
CGAGTCGAGCCGCATACTCGAAGGCCGCTTC	Mycobacterium salmoniphilum
TCGAGCAAGGCGCTGATGCGGTCGCGCGGCA	Mycobacterium salmoniphilum
ATGGTGGTTCCCACAGCGCCACCGTGCGCAT	Mycobacterium salmoniphilum
GCAGAAGTACACCTCGTCGCCCCGGACAAAC	Mycobacterium salmoniphilum
GTGCTCGTGGAGCAGCCGCGCGACGGCACCG	Mycobacterium salmoniphilum
CGACGGCCCCGAATGTAGTGCCGCCGTCCGG	Mycobacterium salmoniphilum
ATACAGGGTCTGCCTGCCGAAAACCACGATG	Mycobacterium saopaulense
CGGCAGGATCGCCCAGCACCTGGATGGCTAC	Mycobacterium saopaulense
GCCCCCACGGAGTGGGCCAAGACGGCTCGCC	Mycobacterium saopaulense
GCGGACACCGAGCACTTCGTATTGGTGCGCG	Mycobacterium saopaulense
GTAACCGATGGCCGAGTTCAGCGGGGTCACG	Mycobacterium saopaulense
TCGTCTGGGCACCGCCATCGCCGAGCGCGGA	Mycobacterium saopaulense
CTGCGGGTGCAGTCATGGATTACTCAACTCT	Mycobacterium saopaulense
CCCATCGACACCGGAACCATCCGGATCGACG	Mycobacterium saopaulense
ACCTTCTCGCGCAGACAGTTTCAGGATCGTG	Mycobacterium saopaulense
CTCGGAACGGATGGGGTGCAGCCGCACCCCG	Mycobacterium saopaulense
CCCTTGGGAGCACCCACATCGGTGACGCCGA	Mycobacterium saopaulense
GGTGCGCTGTTGGATCCCAAGCAGTTTCATC	Mycobacterium saopaulense
CCTACAAGATCAAAAAGCCCGTCGTCACCAA	Mycobacterium saopaulense
CAGCGGCCCACCGATGAGCGCACCCACGATC	Mycobacterium saopaulense
CTGGTGGAACCGTTGCATTGGCGCACTTTTC	Mycobacterium saopaulense
CCACGATGGCCGGCGTACCGATCTTCCTGCC	Mycobacterium saopaulense
ACACACGGAAGGGACGACAGTTAACACTTCC	Mycobacterium saopaulense
AGCACGACATGCGGCTGGTTCGGACCACCAC	Mycobacterium saopaulense
GCCAAGGCCGCCGCCGATGCTGCGGCCGCCC	Mycobacterium saopaulense
AGAAGCTGGGAGTCAAGATCCTCACCGGCAC	Mycobacterium saopaulense
TGCGCGTGGCCGGACCGCACGTCAACGCTCC	Mycobacterium saskatchewanense
CAGCCCGACCAGCGCGGCGCCCAGGGCATAG	Mycobacterium saskatchewanense
TCGTCTCCGCGGTTGTTCGGGCGTCGTTCAT	Mycobacterium saskatchewanense
AGGCCGTCGAGCCGAACCAACGCCCGCTGAG	Mycobacterium saskatchewanense
TGAGTCGTGATGTTCCGCTGCGACTGCTGTG	Mycobacterium saskatchewanense
GGCGCCGATCTCGGCCACCGAGCCCGCACGC	Mycobacterium saskatchewanense
TCGCCCGTCGGATCTGCAGTGAGAATTTCCG	Mycobacterium saskatchewanense
TCACGGACACTGAAGCGCCGACTCGTCGGCG	Mycobacterium saskatchewanense
GCCTTCATACGGAGGAAACTTGCCAAGCGCG	Mycobacterium saskatchewanense
CACGGCGTCGTTCGAGGTGTCGGGCTACCAC	Mycobacterium saskatchewanense
CGGCAGGAGCAGACCGGCGAGCGCCTGTACG	Mycobacterium saskatchewanense
AGGTCCTCGGCGGACTGCGGCCGCGGCGGGC	Mycobacterium saskatchewanense
GCGGGCTCAGCGCCGAGTCCTGCGCCTCCGT	Mycobacterium saskatchewanense
CGAACCGGTTGTATCGGGTGACGGGGTCGTC	Mycobacterium saskatchewanense
GTCGTGCTGGCGGGTGCTGCCCGCCCCGAGC	Mycobacterium saskatchewanense
GCTGTTGGTCCCGGCCGGCCGACTCGGCGAC	Mycobacterium saskatchewanense
CTGGCGGTGTTCGGGCTCGTGCTGGTGCCCA	Mycobacterium saskatchewanense
GCGCCCATGAGAATGCCTGCCTTGAAAAGGC	Mycobacterium saskatchewanense
CCTATTCCTGACCAAGACGGTGTACTCGGTG	Mycobacterium saskatchewanense
TCCCGCTGTTGTGCGGCAAACCATGACTCGG	Mycobacterium saskatchewanense
GTGATCCGAGATGCGGAACACTATAGTGGAG	Mycobacterium scrofulaceum_C
GGTCGGCCACCACCTGATCGGCACCGAGCAC	Mycobacterium scrofulaceum_C
GCGATCAAGTCGTTCCTCACGGTGTCCGCCG	Mycobacterium scrofulaceum_C
CTCCCGGGCCTGCCCGCGCTGTCGCAGCTGA	Mycobacterium scrofulaceum_C
GCTGCTCAACCAGTCTTCGCGGCTCGGCGTC	Mycobacterium scrofulaceum_C
CGCCGACGAACTGGCCCCGCGGCTGCGCCGC	Mycobacterium scrofulaceum_C
CACGCGGTCCGGTTCACTGGCCGAGAGCAGC	Mycobacterium scrofulaceum_C
TCGGCGAGCCGCGCACCAGGAATAGAGGCGA	Mycobacterium scrofulaceum_C
TTCCTATCCTGATCGCTGAACTCGGCGACCG	Mycobacterium scrofulaceum_C
GCGGTCCATCTCCGCGGCCCAGTGGTCGAGT	Mycobacterium scrofulaceum_C
GGACCGGTCCGACGAGCTCCTCGCCGTGGGC	Mycobacterium scrofulaceum_C
CCGCCCGGCTCGACGAGCAGCGCGCCGACAT	Mycobacterium scrofulaceum_C
GCGGTCCGCGTGCCCCGGCTCGTGGTCGGCG	Mycobacterium scrofulaceum_C
GGCCATCGCCGCGAACATGGCCTGCAGCGCG	Mycobacterium scrofulaceum_C
CAAAGGCATCTCCATTCCGACTGCCAGCCGG	Mycobacterium scrofulaceum_C
CCCCGGGCGACGACTGGCCCACCTACAGCAC	Mycobacterium scrofulaceum_C
CGGCGGAAGCAGCCCGCGGTCACGGTAGACC	Mycobacterium scrofulaceum_C
CCCGCTCGAGAGGCCACGCCGGATTAAATAA	Mycobacterium scrofulaceum_C
CCCGGAGTTGAGGATCACCGCGCGCAGGGCG	Mycobacterium scrofulaceum_C
CGGCATCGCGACCTGGGATTGTTTCGGCGGC	Mycobacterium scrofulaceum_C
CCGGCAGCGACGGCGCCTCGCCTCGAAATCG	Mycobacterium senuense
TCACGGCACACCTCCTGCCAACACGGCCGAG	Mycobacterium senuense
CCGCTGCGCACAACTGTCCGCCGACCGGCGG	Mycobacterium senuense
AGCGGCGTGCAGCCCAACAGTTGGCTGATAC	Mycobacterium senuense
GACGTGGTGGCCACCGGGAGCCGGAACCTGT	Mycobacterium senuense
TTCAGGAGGCGCTGCTGTCCGGCGCCGAGCC	Mycobacterium senuense
GGATCGTCTGCATGGTGTCGGTGGCGCTGTC	Mycobacterium senuense
TTGACGCTGCCGGCGCTAATTTCCTTGCATG	Mycobacterium senuense
GTGGCCACGGCGCGCCGGACTGGGCGACGAT	Mycobacterium senuense
GCGCGGCGAAGTGGGCCAGCGCCAAGCCGCT	Mycobacterium senuense
GAGGCGGCCGGTCTGACGGTCCCGCTCATCG	Mycobacterium senuense
GGCCGTCAGCGCCATCGTCAGATTGGTGCGG	Mycobacterium senuense
CGGAACTCGTCGGCCAACGGTCGGCGGAGAA	Mycobacterium senuense
TATCTGGTAGTCCGCCAACAGACGAACGCCA	Mycobacterium senuense
TGCTGACCGGGTTGTGGGGGGTGATCGCCGC	Mycobacterium senuense
TGGAGAACATCCGGTTCGACTCACGCGAGAC	Mycobacterium senuense
GTCCGGGGTCGCGATGCGCGGAATCGCGGGT	Mycobacterium senuense
CGGGGAGACGGCGGCGCCCTACGTTCAGGCG	Mycobacterium senuense
CGAGCAGCGCCGCGAGACCCAGGTGTTACTG	Mycobacterium senuense
GCCTGGGCGAACTCGGGCCAGTGGTCGGCGA	Mycobacterium senuense
GATGCAGCAGCGGGACACCGAAGGCGTAGGT	Mycobacterium septicum
GCCAGGTCGGTGTGGCCGAACAGCTTCAGGA	Mycobacterium septicum
AGGAACGCGCCCGAGCACACCGTCAGGATGA	Mycobacterium septicum
GTAACCGTGCCGGCTGCTGATGAAGCCGTAG	Mycobacterium septicum
AGGATCGGTCCGCTGATCTCCACGACCATCA	Mycobacterium septicum
TCGCAGGCACGGCCCACCACTTGGCCAGCCG	Mycobacterium septicum
CATGCCGACCTTCTGGTCGCCCTCCAACGCC	Mycobacterium septicum
TCGCTCAAAAGATATCGGGGTCGCGCTGTTC	Mycobacterium septicum
CGCTCGGCGAGGGCCTCTTCGGAACCGAGGT	Mycobacterium septicum
CAGCTCGACCTGGACGATGCGCGCAAGCGGG	Mycobacterium septicum
CACCGGCACCTGAAGGGCCTGCTCCAACTTC	Mycobacterium septicum
CGACGACCTCGACGACGACGAGCTGAAGCGC	Mycobacterium septicum
ATCGATCGGTTGGCCGCCGCGCCGGCCGACG	Mycobacterium septicum
CGCAGTGGTATCCGACCACCGGTTGTTCGCC	Mycobacterium septicum
TCGCCGACGATGTGCCCGCGCATCGTGACCG	Mycobacterium septicum
GCCGAACCCAGGATCTTGCGCGAGGTGGTCC	Mycobacterium septicum
ACCTCTTCGATGACCACAGCCAGTGAATGCG	Mycobacterium septicum
AGAGGTCACCGACCGAGCCGGTCGAGCACCG	Mycobacterium septicum
TCAACCCGATGGCCATGATCAGCCCGCCCGC	Mycobacterium septicum
ATTTCGCCGAACAGCTGGATGACATCCTGGC	Mycobacterium septicum
GGGCGACACCGCCAGACCTGACACCCGAGGC	Mycobacterium setense
CGGATTCGAAGTCGCCGTCTACGAATATGGC	Mycobacterium setense
GATGTCCGGCGAACTGGTCGCGACCATCAAA	Mycobacterium setense
CCAGTCCTGCAGTGCAGTCATGGTCGCGTCC	Mycobacterium setense
TCGACGTGGCCCGCGCTGTGAAGCTGATCGG	Mycobacterium setense
GAACCGCGCGCCAGGCCACGGGAATCGTTGT	Mycobacterium setense
AGCGGTTGCTGTGTGAGCTGTGGGCCTGCGT	Mycobacterium setense
TCGCGGGCGACGACGTCGGTCGATTGTCCGG	Mycobacterium setense
TTTCCCCTTGTGGCCGGGGCGCCTGGCATTT	Mycobacterium setense
GACACATAAGTTCAGATTCGGGCTTGGCGTT	Mycobacterium setense
AAACACAACATGACGAAATAGCTTTGCTCTC	Mycobacterium setense
CAGGCCGGAACGCTGGTGCGCGATGTGCTCG	Mycobacterium setense
ATCCTCACCGCTGACCTCGGCACCCGACCAG	Mycobacterium setense
TCGATGACGATTCGCGCGGTCAGGCCACGCG	Mycobacterium setense
TGTGTCGGAATCCGATGACTCGCAGCTGTCG	Mycobacterium setense
CGCCTCTTGTTCGCGGGATTCACCAAAAGCG	Mycobacterium setense
CTGGTGGCCTCGGCATCCGACAGCGCGGCCA	Mycobacterium setense
CGCCGTCAGCAGCCGCACGCTGTCGACCGAA	Mycobacterium setense
AGATAGCCACCGAGTGCACCGCTCTCCGGTG	Mycobacterium setense
GCGGTCAGGTGTGTCAGGCCCGCTGTGCGGA	Mycobacterium setense
CGCCGCGTTCGCCACCGTGGGGACCGTCTAG	Mycobacterium sherrisii
AATAGCTGGGCCAGTGACTCGTAAGTGTATT	Mycobacterium sherrisii
CGGACCTCGGCCTGCAACACCAGGCCGTCGC	Mycobacterium sherrisii
AGGCCGAAGATCGGCCGAATCCCGGTGTGCC	Mycobacterium sherrisii
GCCGGGGAAGCCGCCATGGTCGCCACCGCCG	Mycobacterium sherrisii
ACGCATGGGCGTGACGTTAAGCGTCGGGCCC	Mycobacterium sherrisii
GCGCGCTGCTCGCCGCCGCCGCCGAGCACAC	Mycobacterium sherrisii
CGGCGTCGCCCATGGCGCGCAGCGTGAACGC	Mycobacterium sherrisii
GCGCGTTGCCGAACTGGACACGCAGCTCACC	Mycobacterium sherrisii
CAGACCTCGACGGGCTTCGAGCCGAGGCCGA	Mycobacterium sherrisii
GCCCGGTCGACATCGAGCACGTCGATCACAT	Mycobacterium sherrisii
TCGAATTTGGTAAGCCGTGCCGTCACCGGGA	Mycobacterium sherrisii
CCACCTGGGCCGGCCCCGGGCCGATGCCGAA	Mycobacterium sherrisii
CACGCTGAGCAGCCAGCACGGGCAGGTAGCC	Mycobacterium sherrisii
AGCGCCCCGGCCGCGGCGGCGAATGCCGGTT	Mycobacterium sherrisii
AGATAGTCCTGCACCGCGCCGGCGAACACGG	Mycobacterium sherrisii
GCGGTCGCCCAGGACGAACGCCCTGAGGTCG	Mycobacterium sherrisii
AACGCGCCGGCACCCGGCTGCCCCACCTGAA	Mycobacterium sherrisii
TTTCGCTGGTAGATGGGCCCGGCAGCGGCAC	Mycobacterium sherrisii
GACTACCCGACCGATGAGCACGGCGAGATCG	Mycobacterium sherrisii
ACCCGGTCCGGCGGAAACGCGCCCTCCCCGG	Mycobacterium shigaense
GACCACCGCGTGCTGGCTCAGCAGGTCGACG	Mycobacterium shigaense
AAGCGGCTGCGGGTGGCGGTGGAACCGGCCG	Mycobacterium shigaense
GACTTGCCCGCCCATGTGCTGTTTGTTCATT	Mycobacterium shigaense
CGATGGCCGTGCTGTATCAGGCGGTCGTGAA	Mycobacterium shigaense
AGCCGACGAAGGAGCGCGGTCGGTCGCCTGG	Mycobacterium shigaense
GCAGGCCATCAAAGACGATGCGCGCACGCAT	Mycobacterium shigaense
GGCGTCGAATTGCGGGTTGGCCACCGACTTC	Mycobacterium shigaense
GGTTCCGTTGCCCGGTAACTCGGTCTCTTCC	Mycobacterium shigaense
GTGACCGCAGCGCTGGCCGCCGCGGCCGGCC	Mycobacterium shigaense
GCTCCCCGCCCCGGTCGGCAAATCGGCCTGG	Mycobacterium shigaense
GGTCGACACCGCACACGACGGGATGCGTCTG	Mycobacterium shigaense
GGTGCCACCCGACAACACGTTGGCGTGGGTG	Mycobacterium shigaense
GTCTACGACATGCCGGCGCGCGCTAAGGAAT	Mycobacterium shigaense
TCCGGCTGGGTACCGGTGTGGTGTCGCTGCC	Mycobacterium shigaense
GGGCCGAACGGGTTTCGAGTACGGAGACAAC	Mycobacterium shigaense
AGACCCATCTCACGCATCTGGTCGACGATGT	Mycobacterium shigaense
CATCGGTTGAGCACACGCTGAGGTCCTACGA	Mycobacterium shigaense
AGCGGTCGCGCGTCGCCGCGCCGGGCTCGAT	Mycobacterium shigaense
CGGCACCGCAGTCACCAACCGGGCATCCACC	Mycobacterium shigaense
TACCATCCGCCGGGCTGCCGCGCTGGTCACC	Mycobacterium shimoidei
CTGAGAAATCCCGCCGCCGCCCGTTTGCGCT	Mycobacterium shimoidei
CGCGGGCCAGTTCGGCGATGTCGGGGTTTTT	Mycobacterium shimoidei
TACGCAGCCGCTTCCCGGACCAACGATGGTG	Mycobacterium shimoidei
GCGACCGGCCGGCGCAGCACCGCGGCGGCAC	Mycobacterium shimoidei
CGCAGTCTCGCCGGCCAGGTCGTCGGGCAGG	Mycobacterium shimoidei
CTGCGCCCACGAGTACAGCCGCTGCGACGAA	Mycobacterium shimoidei
CTGCACCCGCACCAGCGCCCGTCGGGCGCGC	Mycobacterium shimoidei
CAGTGCAGCGATGGCGACCAGTGCGCTGGGT	Mycobacterium shimoidei
GCAGTTTCCCGTCGACCGTCTCGAACAGCTC	Mycobacterium shimoidei
GGACATGTCTTTTTGTTCGGTGGCGCCCACC	Mycobacterium shimoidei
ATCCACAACATGTGCGCCGCGCCGACCGCGA	Mycobacterium shimoidei
CGTGACAGACCACTTCGATCTGGGCGGCGAT	Mycobacterium shimoidei
GTTCCTGGGTCTGCAATTTCAGGCCACCCGG	Mycobacterium shimoidei
CAGATTACCTGACGGAATACCCAGCGCCGCT	Mycobacterium shimoidei
GTGCGGCCGCTGCGCTATGTAGTCGCCGGTT	Mycobacterium shimoidei
ACGGAAACCCAGCACTTCGGTGTAGAACTCG	Mycobacterium shimoidei
TCGAGACCGGTGAACTGGGCGAGCGCAACGG	Mycobacterium shimoidei
GCGTGCGGGTGAGGTAAGCGGCGCCACCCCC	Mycobacterium shimoidei
CGGCCAGCGGCACCTTACGGGTGTGGACCCC	Mycobacterium shimoidei
CACCAGCATGTCGGAGCGGGCCAGTACACCC	Mycobacterium shinjukuense
TCCCAGATCAACCATGGTGTCCCCAGATCTA	Mycobacterium shinjukuense
GCCGGCGTGAGAACCGTTGGCGCCGTGGCTG	Mycobacterium shinjukuense
CCACCGGCGGATCACCGCCGGTTTCGCGCGG	Mycobacterium shinjukuense
ACGAGATGACGGGGACCACCGGGGCTTGCGG	Mycobacterium shinjukuense
GCTAGCCTGCCGGCAATGTCTGCATCCGATG	Mycobacterium shinjukuense
TGACGGCCGCGCTGAGCGGGCGTCAATCGGC	Mycobacterium shinjukuense
CGCTGGTTCGATCCCAGCCGGGACCACGCGA	Mycobacterium shinjukuense
TTCGCGTCGTTGATCGTTGGCGGCGGCAGCT	Mycobacterium shinjukuense
CAGGTATGCGTGGCCCGGGATCGGCCGACGC	Mycobacterium shinjukuense
CGCTCCAGTGTCGCCATGCCCGTAGTGCCCG	Mycobacterium shinjukuense
TCTCCAGATAGATCAGACCGCCGCCGCCGAG	Mycobacterium shinjukuense
TGCTTTCCACGATCACCCGCGAGGAAGGTGT	Mycobacterium shinjukuense
ACTCCGCTAGGGCGAGCTTCACAACGATTTG	Mycobacterium shinjukuense
GGGTCCGGACGAGATCACGATGACCACCGGT	Mycobacterium shinjukuense
CGAGGTCGAAGCCTTCCACAAGACCACCTTC	Mycobacterium shinjukuense
ACGATGCGCGCCGCTTGCGGCGCGGTGAGGA	Mycobacterium shinjukuense
CGCGCCGCCGGCGCCGCCGGCTCCCCCGTTG	Mycobacterium shinjukuense
CCGGACCCGGGTTTCGGCGAATGACAACTTG	Mycobacterium shinjukuense
CCAGGTCAACGGTCTGCGCGTCGCAGACACC	Mycobacterium shinjukuense
AGTTTCGATCTGTTGTGGCTGGCGAACGGCG	Mycobacterium simiae
TGCGTTGCACCTCGATGGTTCCCGAGGCCAC	Mycobacterium simiae
ACCATTGTGTTGCTGCTCGTCTACCGCTCCA	Mycobacterium simiae
TAATGGCGTCACCGACATCTTCGGCATCATG	Mycobacterium simiae
GCGGTCATCACCCGGGCCGCATCGCGCATTG	Mycobacterium simiae
ACGGTGTGGTCGGTGGAGGTGGCTGCATCGT	Mycobacterium simiae
CCGCGGAGTGCAGCCCGTCGGCGCCGACGAC	Mycobacterium simiae
CGCGCTTGCCGTGCCGACCGCGGCCATCACT	Mycobacterium simiae
TCGACCAGCCGGCCGGTGCTGATCGCCGCGG	Mycobacterium simiae
GTCGCCGACCGACGCACTCACCCGCGCGAGA	Mycobacterium simiae
CTATGTGGCCGAACGGCTTTTGCAAGGGCAC	Mycobacterium simiae
TGCTTGCCCGACAACTAGTCCGTGGGCTTCG	Mycobacterium simiae
CTTTCCTGTCCCCCGACGCTGGCCACCGGAA	Mycobacterium simiae
GGTGGCCGCCGGCCTCGGGACGATGCTCGGG	Mycobacterium simiae
AATGCGCGGTTGCGGGCGTCGATCTCGTCCT	Mycobacterium simiae
CATCGAGGTGGATGAGGGGCCCAGCCATGAC	Mycobacterium simiae
CCCGCACCTCCCCGCCGTGGGCGTTCTTCTC	Mycobacterium simiae
GCGGGTGGCGATCGCCGGGCACGACGGGCTG	Mycobacterium simiae
GCTTCGAAAAGCCGTGGCCGTTGCTGTGGTT	Mycobacterium simiae
AACCATGCGGGTCCGCAAAGATCACCGTGCC	Mycobacterium simiae
GGGCCGATGCCGGTCGCGGTCGAAACTTTCC	Mycobacterium simulans
TCCGGCATTGGTGTGGAACACGACGACCACC	Mycobacterium simulans
CGGCGTCCACCACGGTGCCCGCGCCCTCATT	Mycobacterium simulans
CGTGCGCACCCGGGAACGCCGGCAACAGCGC	Mycobacterium simulans
GGGAAATTCACGGGGTTCGACGCCCGCACCC	Mycobacterium simulans
CGACGGTTACACGTCCTAGCGACCAGCCGCG	Mycobacterium simulans
GTGAAGATCCGTACCGCCGCACCCGAATTCC	Mycobacterium simulans
CGCGAGCCCGCTGATTCAAAGAACCCACCCC	Mycobacterium simulans
ACGATGTCGTCGCTCAGATCACCGGGATCGA	Mycobacterium simulans
GAACTCGACGACTGGGGTCCGCGGCTGCAGC	Mycobacterium simulans
CGGAACTCGGCGATGGGCACATCCCGTTGGA	Mycobacterium simulans
ATTGCGCGATATCACCATGGAGCTCAACCTC	Mycobacterium simulans
AGCAGCCGTAGCCGGGCAACGCCAGGATTCA	Mycobacterium simulans
TCCGAAACCGCAGTTGCCGGGCCAGCCGCAT	Mycobacterium simulans
TGGCGGAATACTACGCGCGAGCGCGCCACAT	Mycobacterium simulans
GCCTACCATCCCTTTCTCGTCGCCGGTGTGC	Mycobacterium simulans
ACTCATCCCCGCGGTGCTCGACTCCATCCGC	Mycobacterium simulans
GACCTCGAATCCGGCGCGGCCTTCCAGGCGG	Mycobacterium simulans
GAGCGTGCAGGAGTTGACGACAACCTGCTCG	Mycobacterium simulans
CGTCGTGACGACGATTTGGCCTGGCGGGAGC	Mycobacterium simulans
CTGATCCACCGCCGCCGGGTGGCCGGAAAGC	Mycobacterium sinense_A
AAGCGGGCCCGGGCGCCGATATGCCCGGCGA	Mycobacterium sinense_A
GAGCAGCGTCGACAACACCAGCGGGTAGCGG	Mycobacterium sinense_A
CGCCCCTCACCGAGTTGGTCGGGCAGGGTGT	Mycobacterium sinense_A
GACGCCGAGGCCGCGGTGCACCACGGGTTGG	Mycobacterium sinense_A
GTAACACTGTTCAGTTCGCCGTGCTGCGGCC	Mycobacterium sinense_A
GGCTGCGGTGTGACGTCGGAAATCGCGCCGA	Mycobacterium sinense_A
CTGCCTGGGTACGCACTATGCCGGTGGCGTG	Mycobacterium sinense_A
CGATCACGCACGGCAAGTCCGTCGTCACCGC	Mycobacterium sinense_A
TCGGGCCGTGGCGAGCGAACGTCGAGCGGGA	Mycobacterium sinense_A
GACCGGTTGGACTACCGCAGCCTCGCCGAGA	Mycobacterium sinense_A
TGGCAGCCAGTGTGCCACCGGTGGCCAGAAC	Mycobacterium sinense_A
TTCCCATGTCATTGAGCAGGGACTGCAGGCT	Mycobacterium sinense_A
CGGGAATCTGCCACGCTCGCTGTTCGATTCG	Mycobacterium sinense_A
GACCGCCCAGACCTCGTCGACGCCGAGCAAC	Mycobacterium sinense_A
GGTGGGCAGATGGCGAACGAAACCGACGGTG	Mycobacterium sinense_A
AGATGGGTCTTCACGTCGCCGCCTTTCCGCT	Mycobacterium sinense_A
TTCGCATCCGATCCGGATTCCCTCCTCGCTG	Mycobacterium sinense_A
GTGATACGTCGGTACTACGACAGCGAAACCA	Mycobacterium sinense_A
GGCCGACGTTGCCGGCGATCTGTTCGGCGGC	Mycobacterium sinense_A
TCAACAGCATCACCGTGATGACGGCGAACGT	Mycobacterium sinense_B
GGTGGCGGCGTAGGTCAGTGCTCCATCGGTA	Mycobacterium sinense_B
CGGCGGCGAACTACATCTTCGACGACTCCAG	Mycobacterium sinense_B
CGGCGGCCCACTGCGCAATTCGGCTATGCCG	Mycobacterium sinense_B
AGGACGACACGCGATTCCGGCGTGTTCCAGC	Mycobacterium sinense_B
CTCACCCGCATCTTTCACTAAGCCAAGGCAC	Mycobacterium sinense_B
GCTCAGAGATGCGGTTTGGCGACGCTGATCA	Mycobacterium sinense_B
CACGGTGACCGAACTTCGGTTTCGGTTTGGG	Mycobacterium sinense_B
TCATAGGCGACCACCCGGATCAGCGGATGCC	Mycobacterium sinense_B
CGGCAATCCTGTAATCCGGTGCGCGCCACGA	Mycobacterium sinense_B
ATTTGGGCACGTAGTACACCGGGTGGTGATC	Mycobacterium sinense_B
ACGCCGTCGGGCTGGCGCGCCGACCGGGGAT	Mycobacterium sinense_B
TGGGCCTGTTGACCGGGAGCCGGCGCCGCGG	Mycobacterium sinense_B
TGCACTGCAACGATGAGCACCACCGCGATGG	Mycobacterium sinense_B
TGGCGCTGCACGGCCTCGTGGATCGGCCGGT	Mycobacterium sinense_B
CGGCGTGCGCGGTGCCCGAACCCCGCGCCCA	Mycobacterium sinense_B
GCCTTCTCCGCGGACGCGGATCGGCGCAGTG	Mycobacterium sinense_B
CAAGGGCGACATCCAAGTGTCGAAGTTCCAC	Mycobacterium sinense_B
CGGTGGGCCGCCTCGCAACAGCGCCCAGGTG	Mycobacterium sinense_B
CGGGGCTGATCGTCCTGGTCGGTCGGGCCTT	Mycobacterium sinense_B
TGCTCGACGGTGTCGACGCGATCGGCGGGGA	Mycobacterium smegmatis
GCGCGTCGCCGAAGGGTGATCGACACCGGTT	Mycobacterium smegmatis
GGCACGCCCTGACTGAGCCTCGACACCATCG	Mycobacterium smegmatis
GTGCCCTGCGCTACCGCGGCGTCGACATCGA	Mycobacterium smegmatis
AGAACTACCCGATCGACGCCAACGCGCTGCT	Mycobacterium smegmatis
ACGAACTTGGTTCATCACGGGGTCATCCCGC	Mycobacterium smegmatis
GCACGGTGTTCCTGGTGGACACCGCCGAACT	Mycobacterium smegmatis
CCGAGACGCTGCCCGCCGCGCTCGAGGTCGT	Mycobacterium smegmatis
GCGCGGCGGAAGTAGCCCGGGTTGAAGTCCA	Mycobacterium smegmatis
TGCATCGCCCGCGGCAGGTCACTGACCCACT	Mycobacterium smegmatis
CTGGTGGTCGGTGATCCGGGTGACGGTCGTG	Mycobacterium smegmatis
GCGCTGCCGCGGTAGCCGACATCCATCGCCG	Mycobacterium smegmatis
GTGTTCCGCAACATGATCGCCCAGCACGGTC	Mycobacterium smegmatis
CCGGTGATGTTGTGCAGCAGCATGACGCCGT	Mycobacterium smegmatis
CGACGACAGCCCGGCCGGCACACCGGGTTTC	Mycobacterium smegmatis
CCCGCGTCAACAACCGCGAATCCTCCGACGG	Mycobacterium smegmatis
GTTCTGCGTGGCCTCGTAGTCGGCGAAACGC	Mycobacterium smegmatis
GCCGACCACCGCTGGCCGTGCGGATCGCCGC	Mycobacterium smegmatis
CGAGACCGAGGAACAGCAGGCGCTGCGCCGC	Mycobacterium smegmatis
TGTGCCTGACCGTGGCGGCCATCGTGCTGTG	Mycobacterium smegmatis
TCCGACCGTGCGCAGGTGGCGACCGAGGTGC	Mycobacterium syngnathidarum
TGCACGGTGACCGAATCCTCCAGTTCATCGA	Mycobacterium syngnathidarum
CAGCTTGTCCTCGTAGCGCATCGTCTGTGCG	Mycobacterium syngnathidarum
CGACGTGGTCCCCGCCGCGAGATGTGCCCAT	Mycobacterium syngnathidarum
TACCTCGGCGCATCACACCTGACGGTTGAAG	Mycobacterium syngnathidarum
GATGGCCCGGGCCTGCCTGAATCTGGTCGAA	Mycobacterium syngnathidarum
CCGCCGCATCCAGATGCGCTCGCACGATGCC	Mycobacterium syngnathidarum
TAAACGCGGCCAACTGGTCCGGACCCTGGAT	Mycobacterium syngnathidarum
CGCCCACAACAAGGGCAACTCGGGGATCGGT	Mycobacterium syngnathidarum
CCGTAGTGACGATCCCCGGCGCAGACTTTCG	Mycobacterium syngnathidarum
TCCATGTTTTTGTCCTGCATTGGCGGCCCAG	Mycobacterium syngnathidarum
CCGGTCAAGGGGCGACCGCGCGGGTGCACCC	Mycobacterium syngnathidarum
GGGAGGACTACACCGCCGCCAAGGAAGACAT	Mycobacterium syngnathidarum
CACGACGACGGGACCGGCGCGGTCCTGGTGG	Mycobacterium syngnathidarum
GATCACCGACCACGGCGATGGCGACCACCGA	Mycobacterium syngnathidarum
ATCGGCAGCCAGCGGGTGCGCGGGTACATGG	Mycobacterium syngnathidarum
ACGCCTTCGGCGCGACCCGAATCTTGACCCC	Mycobacterium syngnathidarum
GCCAAGGCCCATCCGGTTCCGGCGAGATCGA	Mycobacterium syngnathidarum
TCCACCCTCGGACCATGGCAGTCGACCTCGA	Mycobacterium syngnathidarum
GCAGGGCCGGGTGGTGGAGGAGGGCACCCAC	Mycobacterium syngnathidarum
AGCAGGGACTGGCCGCGGTGGCGGTGGCTTC	Mycobacterium terrae
CCGGGCTGGGCGCGGCGGCCGCCTGGCAGGC	Mycobacterium terrae
TATCGCGGCCCGCGCGGCGGCCCAGTGGTAG	Mycobacterium terrae
GATGGTCTCCTGCCGGCTGACCGAAAGTCAG	Mycobacterium terrae
CGGTCAACGCGTCCTCGTACCCGGCGGCGTC	Mycobacterium terrae
CTTGTCGTAGTGGTCAACGGGGCGGGTCCGG	Mycobacterium terrae
TATTTGTTTCGCTGATTTCGATCTGCCCGGG	Mycobacterium terrae
TTCGCAGGCCCCGGCGGCGCGTGCGCCGATC	Mycobacterium terrae
CCAACCGGGCCGGCGGGCTTGAAGGCGGAAT	Mycobacterium terrae
AGGAGGATTCCCGCTTTTTCAAGAAGCACTA	Mycobacterium terrae
TCACGGGTGAAGCCGCCCTCGGTTCCCGGTG	Mycobacterium terrae
CCTTCGACCAGGTACGCCCGGCAGCGGTCCG	Mycobacterium terrae
CCCGAAGGCCGTCGGGCCAGCACGACGACGT	Mycobacterium terrae
CGTGCAACTGCCGCTGCCCAAACAGCTGGAC	Mycobacterium terrae
GCTGTTGGGCCACACCCTCGACGACCAGGCC	Mycobacterium terrae
AGGTTGAGCTTTCCCGGCGCCCGCACGGTGA	Mycobacterium terrae
CAGTTGCCGGCTCCGGTGCGCCTGGTGGGCC	Mycobacterium terrae
CATCTTCTTCATCGGCCGGTATCACGAGGCC	Mycobacterium terrae
ACACCCGCTGCGCGCGGATCACCATGTCGAG	Mycobacterium terrae
AAAGGTCTGCACCGCGTGCCCGACGGCGGCT	Mycobacterium terrae
GACCAGGCCGGCGTCGGGTTCGGTGGTCACC	Mycobacterium thermoresistibile
CTACAGGGGGGGACGATGACGTCGACGTTCG	Mycobacterium thermoresistibile
TCTGATCATCGCCCATCACGACCGGCTGTGC	Mycobacterium thermoresistibile
AGCAACAGACCGGTGATCATGAAGGCAAACG	Mycobacterium thermoresistibile
CGGCATCGCCGCGGCCGGGCCGGCCTTGGCG	Mycobacterium thermoresistibile
AGCGCCTCGCACGTTGCCGTGATCTCGTCGG	Mycobacterium thermoresistibile
GGATCTGCCGGCACAACCGCTCGAACCGCCA	Mycobacterium thermoresistibile
CACCATGCCGGCGCTGCTGCTGTGCGTGGCG	Mycobacterium thermoresistibile
GTCACGCCGCGGACACGCCGAGCACCCGCTG	Mycobacterium thermoresistibile
GAGACGCCGCGGAATCTGCTGGGGTTCAAGG	Mycobacterium thermoresistibile
GACAGGTCCTGCACGCCCAGCAGGGCGGCCG	Mycobacterium thermoresistibile
TGACGGTGGCCACCAGCGGGTGGGTGAAGAA	Mycobacterium thermoresistibile
GCTGGGGGTGGAGCTGTCATGAGGCCACGCA	Mycobacterium thermoresistibile
CCACATGCAGGACGAACCCGGGCATATCGGC	Mycobacterium thermoresistibile
CCCCTCGCCGTACTCCTTGACGGCCGCGTCG	Mycobacterium thermoresistibile
CCGGCCACACAGGCCGCACACCACAGGGAGG	Mycobacterium thermoresistibile
CCGGGATCGGAACGGTCACCGCGCACGTCGA	Mycobacterium thermoresistibile
GTCGTCGACGTGTGGAAGGTCGCCACGATCG	Mycobacterium thermoresistibile
GGAAGCCGCACCGCCAAGCGCACCCCCACCG	Mycobacterium thermoresistibile
ATTCGGTCACCAACGCGCAGCTGAGCGCGGT	Mycobacterium thermoresistibile
GGGGTCTTCAAGGCGAACGTGAAGGTGCGGT	Mycobacterium tokaiense
CGTGGTGCCGCCCTGGCGCGAAGGCGGTCAG	Mycobacterium tokaiense
CCGCGGATCGGCCACATGGTCGGGCTGCAGT	Mycobacterium tokaiense
GTGCTCTCCTGTGTGACGGTCACTTCACGGC	Mycobacterium tokaiense
CCGTCTCCGACAACACCCACCGCATCCATTC	Mycobacterium tokaiense
AGCAGGTCCAGCTGCGCGGTCGCCGAGTTCT	Mycobacterium tokaiense
GCCGACCGGGTGACCGGGAACACCTCGCCGC	Mycobacterium tokaiense
CCGCTCGTCCTGCTGTCGGGTCATGCCACGC	Mycobacterium tokaiense
GCGGCCACCGCCGCCGTCGCGGCGTCGCGGG	Mycobacterium tokaiense
CCACCGGTTCGAGCCGCAACTCGACGATGGG	Mycobacterium tokaiense
CCAGTAGCCGATCAGGCGCTCGCGGCGGCGC	Mycobacterium tokaiense
CGGCGACCCGCTGACGCAGCGCACCGCGCGC	Mycobacterium tokaiense
ATCTGGACGTAGCAGGCCAGGGCGGGTGATT	Mycobacterium tokaiense
GTACCGGGCCGGAGATCATTTCGCCGAGGAA	Mycobacterium tokaiense
GCTGGGCGTGTCCGGTGTCCTGGTATTCGTC	Mycobacterium tokaiense
CGGATCAAGGCCGCCCGTCGGGCGCTCGGGG	Mycobacterium tokaiense
CGATCTCGTCGGCCGGTTCCAGCGGAATCCC	Mycobacterium tokaiense
ATCATTCGTGGTCGTTCAAACTCGACGGAAG	Mycobacterium tokaiense
CACCGGGTCCACCGGCAGGATCGTGGTCCCG	Mycobacterium tokaiense
CAGATGTGTCAAAATGGCCTATGCCACCGGC	Mycobacterium tokaiense
CACCAGCCTGGAAACATTGTCCGTAGCCTCC	Mycobacterium triplex
AAGGTCGTCGAAATGGCTATTGACCAGAGCG	Mycobacterium triplex
ATGTTGGGTGGTAACGCAACTGGCAATCTGT	Mycobacterium triplex
GACGTCGCCGACGTGCAGCCGGATATGGTGG	Mycobacterium triplex
ACCCCGAAGGACGCCGGTCCCGTCGTCCTCA	Mycobacterium triplex
CGCGGTGTTCGACCGATGGAACGGCCAGGTC	Mycobacterium triplex
ACGGCGCACGGGGGACCCCGCGGCTAGGCGG	Mycobacterium triplex
CCAGCACCACCCGAGCCGAAAGCAGGTTATC	Mycobacterium triplex
ATCTTTCGGACGCCGAGCGGTCGGCTCTTCA	Mycobacterium triplex
CCAGGCGCGTTGCGCGGAAGGCGGGCTCCAG	Mycobacterium triplex
CACCACCTTCACCACGATTGCCCTGCAGCAG	Mycobacterium triplex
CGGTCGGCGACCGCCGGCCCGGCCGCCGAAC	Mycobacterium triplex
CAACTGCGCGGCGTCGGTATTCTCATCCAGG	Mycobacterium triplex
AGGTGGCGATGGCCGGCTCCAGCGCCTCCAT	Mycobacterium triplex
ATGCTGAACATCCCTAGGAACGCAGATGCAG	Mycobacterium triplex
GCTGCGATGGCTGGCGGTGACGACCGGGTCC	Mycobacterium triplex
GACCGGGAGTCATTCCGGGACCGGTGGCTCC	Mycobacterium triplex
GCTTCCACAGCACGTCGCCCTCCGGGTTGGC	Mycobacterium triplex
GGGTGATAGGTCGCGTCTTCTTCTCCGCCGA	Mycobacterium triplex
TGTGGTGGCACCCGGTGTCGACGAGACGATG	Mycobacterium triplex
AGCAAACCATCGAACCCGGATGGCTATACAT	Mycobacterium tuberculosis
CGGTGGGCTCGCCGCCTTCGGTGTACCTGCA	Mycobacterium tuberculosis
CGCCTGAATCGATGCGGCGTCGCTGGGGCTC	Mycobacterium tuberculosis
AAGAAGCAGCGCGGGGAGCCCGTGAGCTGTT	Mycobacterium tuberculosis
GTCGGTGAACTCCGCAAGGTTCTTGTTCAAC	Mycobacterium tuberculosis
GCACCAGCGCCTTGGACGCCGAAGTGGTAAT	Mycobacterium tuberculosis
ATCGATACCGTCGTGCGTGCGGCGAAGGTAG	Mycobacterium tuberculosis
AGCCAGGAAGACGAGCGGTCGCCGAGCGGGC	Mycobacterium tuberculosis
GGAGTGGCCGGATATCCGCTCTTGGCTTCCG	Mycobacterium tuberculosis
CTCGATGACGCTGCCGTCCACGGTGTCGAGG	Mycobacterium tuberculosis
AGCAACCACGTGGCAATTGCCAACGGGGACT	Mycobacterium tuberculosis
ATTGGCGTTCGAGACCACCCGCTTGCCGTCC	Mycobacterium tuberculosis
AGATACGAGTCTTGCTTGGTCCTGCGGCGGT	Mycobacterium tuberculosis
CGGTAGTGCAGAAACGAGTCCAGCGTGGGCA	Mycobacterium tuberculosis
GCACAGAACACCCGCGGGCTGCCGGTTGAGC	Mycobacterium tuberculosis
GGCGGTCAGCTCCGGTCTTGGCCGCCGAATC	Mycobacterium tuberculosis
CGCCGAATATCAAAGGCGAACAGCCTATTTC	Mycobacterium tuberculosis
CCGGGTGCTCGGCCACATCGAGCACGAACTG	Mycobacterium tuberculosis
TTCCTTCGGCAACATTCACGACTCGTTGTCG	Mycobacterium tuberculosis
GCTCACGAGCGAGCCACCTCCACCATCTCGA	Mycobacterium tuberculosis
CAAAGCCGCCGCCGTGCTGGGCCAGGTCGAC	Mycobacterium vaccae
GCGGTACCCGAAGTAGTCCTCCATCCCCATC	Mycobacterium vaccae
CCGAGACCGCACGCCCCGACCCGCTGATCGA	Mycobacterium vaccae
AGTGTGGACTTCGTCGACGCGCTGCCCCGCA	Mycobacterium vaccae
AACTCACCGGTGAGTACCGCGGCGGCCCGGC	Mycobacterium vaccae
CTGCAGGATGTCATGCTCTCGCAGCTGAACT	Mycobacterium vaccae
GCGGTCGGCGAAACCGAACGTCGGCTCCGCC	Mycobacterium vaccae
CCGGCGTAGCTGGCCGAACCGAAGACGCGCC	Mycobacterium vaccae
GTCGCCGTCGAACAGATGGTGCAGCGGCCGA	Mycobacterium vaccae
CGGCTGGTGATCTCGAGGGTCTTCATGGCGG	Mycobacterium vaccae
GCGCGTATCCTGACCACGCTGCTGTACCACA	Mycobacterium vaccae
CCACCGCGCGTGCGGCCCGGTTGTACGGCGC	Mycobacterium vaccae
GTCGAGCAGCCCGAACTCGGTGCCGGCGGTG	Mycobacterium vaccae
CTCCGGGGTGGTCTCGGCGGTGGTTTCAGCG	Mycobacterium vaccae
GTCTCCACCCGGCACGAGGCGGCCATCCTGC	Mycobacterium vaccae
CCGATCACCGCGCTGCCCAACGCCAGCATCG	Mycobacterium vaccae
CGTCTCGGCGCCGACGGCGTCGCCCGCGCGC	Mycobacterium vaccae
GAGGACGTCGACGCCGAGATCGAGTCGCTGC	Mycobacterium vaccae
TTCCGGGCCGGGTGGCCGAGCTGCGACCCAG	Mycobacterium vaccae
TCGGGGCGCACGTCGTACCCGCGCCCGTCGC	Mycobacterium vaccae
GGGAGCCGCGCAGACGAAGTCGGGGGAGTAG	Mycobacterium wolinskyi
ATGACGTGCTGTGCGATCCGCAGAGCGCAGA	Mycobacterium wolinskyi
AGTAGCTGCGACTCGTTGCGCAGCGCGGTCA	Mycobacterium wolinskyi
TAGTGGTCGGGCTCCATGAGCCCCGGGTGCT	Mycobacterium wolinskyi
CGGCCCACGCGGGGCCCGGGTCCCTGCATCA	Mycobacterium wolinskyi
CTATGCGCCGCCACCCATGCCGTTGGGTCCG	Mycobacterium wolinskyi
CCCGACGGAATCGACTATGCGAGAAGCTCGC	Mycobacterium wolinskyi
GAGGCTTCGATAAGGCAGCTCTGGCAACCTT	Mycobacterium wolinskyi
ATGTCTGCAGATACATCCCGGTGCCGTCTTT	Mycobacterium wolinskyi
CATATCTGGAACGGTAGTGGTCGCTTCGCCA	Mycobacterium wolinskyi
GCCCCCGTACCGAGGAACTCCGCGAACGCCA	Mycobacterium wolinskyi
ATCTACACGCACGTTTCGTATCCTTTGCTGA	Mycobacterium wolinskyi
GGAGGCCGCGGAGTTGGCCGGGATCGCCCAA	Mycobacterium wolinskyi
TGCCGCCTGCCTTCTCGAAGGACGCGATCAT	Mycobacterium wolinskyi
GTTGGTGTTGACGGGTGTGGGGTTGCTCGCG	Mycobacterium wolinskyi
CCCGTACCGGGCGGGTCGTGACCGCGGCCGC	Mycobacterium wolinskyi
GGATGGGAGCGGGGCATATGAGGTTTCGGTT	Mycobacterium wolinskyi
CCGGAGCAGATGTTCGACACCATCGCGATCA	Mycobacterium wolinskyi
CTCGAGGCCGATCCGCACCTCGAAGCCGACT	Mycobacterium wolinskyi
CATCGGCAAGAACGGCACCGCACGGATGGCC	Mycobacterium wolinskyi
GCACGGCTCGATGCCGTTTTGCGTGCGGTAG	Mycobacterium xenopi
GCGGTAGCCGCCGCGTCCGACGTAGACCACT	Mycobacterium xenopi
ATCACCCGCCCTAGCGCGGCATCGCCGGCGG	Mycobacterium xenopi
TCACAGCCAGGTCGCCGGTGTCGACGGTGTA	Mycobacterium xenopi
AGAGCTACGGTGCCCGAATGCTAGTCGCGGG	Mycobacterium xenopi
AGCAGTATCTGCTGTGGGGGCTGGGCAGCTT	Mycobacterium xenopi
CGCCCGCAGCACTCGCTGGTGCACCTGGTCG	Mycobacterium xenopi
ACCAGTACCGCGCCGCGGAATTGGCCCACGC	Mycobacterium xenopi
GTGCAGGAAGCGATCGAGTCCGAGCCCGGCG	Mycobacterium xenopi
GGGCGCGCCGCTGACATACCTGTGGCTAGCG	Mycobacterium xenopi
GGCGTTTCGATGAGAAATTCGATCGATTCGA	Mycobacterium xenopi
CAGTCGAGCAAGGTGCATGCCGAGACACATG	Mycobacterium xenopi
GCCAGCCCCGCACCCGGGATGACCCGTGTGG	Mycobacterium xenopi
CACAATCACGTCCCACACGGCGTGTTCCGCC	Mycobacterium xenopi
AACAAGTTGCGCGCGTTCCAGTCGCTTTCGC	Mycobacterium xenopi
TCAACTTCCGCGACACGTTCCAGTGCGGCAA	Mycobacterium xenopi
CGACCCGCATTCACCGCTGGCTGGCACACTC	Mycobacterium xenopi
CGGCCAGCATGGTCTGCGGCGCCCCGCGTAG	Mycobacterium xenopi
GTGGTGGCCCGCCAATTCCGCCGGGCCGGCA	Mycobacterium xenopi
CCCGCACGTCAAGGTGTCGCGACGATGCGGC	Mycobacterium xenopi
